ᎠᎢ	PresentContinous	ᎠᎢ:Walking
ᎠᎢᏐᎢ	Habitual	ᎠᎢ:Walking
ᎠᎦᎴᎾ	Immediate	ᏓᎦᎴᏂᎠ:Separating
ᎠᎦᎴᏂᎠ	PresentContinous	ᏓᎦᎴᏂᎠ:Separating
ᎠᎦᎴᏂᏍᎪᎢ	Habitual	ᏓᎦᎴᏂᎠ:Separating
ᎠᎦᎴᏂᏗ	Deverbal	ᏓᎦᎴᏂᎠ:Separating
ᎠᎦᎴᏅᎥᎢ	RemotePast	ᏓᎦᎴᏂᎠ:Separating
ᎠᎦᎵᎭ	PresentContinous	ᎠᎦᎵᎭ:Shining (the sun)
ᎠᎦᎵᎯᏍᏗ	Deverbal	ᎠᎦᎵᎭ:Shining (the sun)
ᎠᎦᎵᏍᎪᎢ	Habitual	ᎠᎦᎵᎭ:Shining (the sun)
ᎠᎦᎵᏒᎢ	RemotePast	ᎠᎦᎵᎭ:Shining (the sun)
ᎠᎦᎾᏬᎯᏍᏗ	Other	ᎠᎦᎾᏬᎯᏍᏗ:Heater
ᎠᎦᏁᏍᏗ	Other	ᎠᎦᏁᏍᏗ:Button
ᎠᎦᏍᎩ	Other	ᎠᎦᏍᎩ:Rain
ᎠᎦᏍᎬᏂᏓ	Other	ᎠᎦᏍᎬᏂᏓ:Left-handed
ᎠᎦᏐᏓ	Immediate	ᎠᎦᏐᏗᎭ:Going down hill
ᎠᎦᏐᏔᏅᎢ	RemotePast	ᎠᎦᏐᏗᎭ:Going down hill
ᎠᎦᏐᏗᎭ	PresentContinous	ᎠᎦᏐᏗᎭ:Going down hill
ᎠᎦᏐᏗᏍᎪᎢ	Habitual	ᎠᎦᏐᏗᎭ:Going down hill
ᎠᎦᏐᏙᏗ	Deverbal	ᎠᎦᏐᏗᎭ:Going down hill
ᎠᎦᏓ	Other	ᎠᎦᏓ:Much
ᎠᎦᏔ	Other	ᎠᎦᏔ:Eye ball
ᎠᎦᏔᎲᎠ	PresentContinous	ᎠᎦᏔᎲᎠ:Turning
ᎠᎦᏔᎲᎾ	Immediate	ᎠᎦᏔᎲᎠ:Turning
ᎠᎦᏔᎲᏍᎪᎢ	Habitual	ᎠᎦᏔᎲᎠ:Turning
ᎠᎦᏔᎲᏍᏗ	Deverbal	ᎠᎦᏔᎲᎠ:Turning
ᎠᎦᏔᎲᏒᎢ	RemotePast	ᎠᎦᏔᎲᎠ:Turning
ᎠᎦᏖᎾ	Other	ᎠᎦᏖᎾ:Lace
ᎠᎦᏙᎵ	Other	ᎠᎦᏙᎵ:Eye
ᎠᎦᏙᏍᏓ	Immediate	ᎠᎦᏙᏍᏗᎭ:Looking
ᎠᎦᏙᏍᏓᏅᎢ	RemotePast	ᎠᎦᏙᏍᏗᎭ:Looking
ᎠᎦᏙᏍᏗᎭ	PresentContinous	ᎠᎦᏙᏍᏗᎭ:Looking
ᎠᎦᏙᏍᏗᏍᎪᎢ	Habitual	ᎠᎦᏙᏍᏗᎭ:Looking
ᎠᎦᏙᏍᏙᏗ	Deverbal	ᎠᎦᏙᏍᏗᎭ:Looking
ᎠᎦᏛᎲᎦ	Immediate	ᎠᎦᏛᎲᏍᎦ:Investigating
ᎠᎦᏛᎲᏍᎦ	PresentContinous	ᎠᎦᏛᎲᏍᎦ:Investigating
ᎠᎦᏛᎲᏍᎪᎢ	Habitual	ᎠᎦᏛᎲᏍᎦ:Investigating
ᎠᎦᏛᏅᎢ	RemotePast	ᎠᎦᏛᎲᏍᎦ:Investigating
ᎠᎦᏛᏗ	Deverbal	ᎠᎦᏛᎲᏍᎦ:Investigating
ᎠᎦᏥᏅᎪᎡᏍᏔ	Immediate	ᎠᎦᏥᏅᎪᎦ:Rusting
ᎠᎦᏥᏅᎪᎢᏍᏗ	Deverbal	ᎠᎦᏥᏅᎪᎦ:Rusting
ᎠᎦᏥᏅᎪᎦ	PresentContinous	ᎠᎦᏥᏅᎪᎦ:Rusting
ᎠᎦᏥᏅᎪᎪᎢ	Habitual	ᎠᎦᏥᏅᎪᎦ:Rusting
ᎠᎦᏥᏅᎪᏨᎢ	RemotePast	ᎠᎦᏥᏅᎪᎦ:Rusting
ᎠᎦᏳᎳᏗ	Other	ᎠᎦᏳᎳᏗ:Seine
ᎠᎦᏴᎵ	Other	ᎠᎦᏴᎵ:One thousand
ᎠᎦᏴᎵᎨᎢ	Other	ᎠᎦᏴᎵᎨᎢ:Woman, elderly
ᎠᎧᎾᏅᎢ	RemotePast	ᏓᎧᏂᎭ:Opening eyes
ᎠᎧᏂᎦ	Immediate	ᏓᎧᏂᎭ:Opening eyes
ᎠᎧᏂᎭ	PresentContinous	ᏓᎧᏂᎭ:Opening eyes
ᎠᎧᏂᏍᎪᎢ	Habitual	ᏓᎧᏂᎭ:Opening eyes
ᎠᎧᏅᎢ	Other	ᎠᎧᏅᎢ:Eye
ᎠᎧᏅᏗ	Deverbal	ᏓᎧᏂᎭ:Opening eyes
ᎠᎧᏍᎨᏂ	Other	ᎠᎧᏍᎨᏂ:Hip
ᎠᎧᏎᏍᏓ	Immediate	ᎠᎧᏎᏍᏗᎭ:Watching
ᎠᎧᏎᏍᏓᏅᎢ	RemotePast	ᎠᎧᏎᏍᏗᎭ:Watching
ᎠᎧᏎᏍᏗᎭ	PresentContinous	ᎠᎧᏎᏍᏗᎭ:Watching
ᎠᎧᏎᏍᏗᏍᎪᎢ	Habitual	ᎠᎧᏎᏍᏗᎭ:Watching
ᎠᎧᏎᏍᏙᏗ	Deverbal	ᎠᎧᏎᏍᏗᎭ:Watching
ᎠᎧᏔ	Immediate	ᎠᎧᏘᎭ:Peeking
ᎠᎧᏔᏅᎢ	RemotePast	ᎠᎧᏘᎭ:Peeking
ᎠᎧᏘᎭ	PresentContinous	ᎠᎧᏘᎭ:Peeking
ᎠᎧᏘᏍᎪᎢ	Habitual	ᎠᎧᏘᎭ:Peeking
ᎠᎧᏙᏗ	Deverbal	ᎠᎧᏘᎭ:Peeking
ᎠᎨᏯ	Other	ᎠᎨᏯ:Woman
ᎠᎩᎦᏔᏄᎶᏓ	Other	ᎤᎦᏔᏄᎶᏓ:Eyelid
ᎠᎩᎦᏘᏳᏩᏅᎢ	Other	ᎤᎦᏘᏳᏩᏅᎢ:Eyebrow
ᎠᎩᎨᏬᏗ	Other	ᎤᎨᏬᏗ:Bald
ᎠᎩᎩᎯᏍᏗᏳ	Other	ᎤᎩᎯᏍᏗᏳ:Throat
ᎠᎩᎬᏫᏳᎯ	Other	ᎤᎬᏫᏳᎯ:Ruler
ᎠᎩᎳ	PresentContinous	ᎤᎩᎳ:Horse (on a)
ᎠᎩᎳᎾ	Other	ᎤᎳᎾ:Mother's brother's wife
ᎠᎩᎴᏍᏓᎸᎢ	Other	ᎤᎴᏍᏓᎸᎢ:Vagina
ᎠᎩᎵᏍᏆᏗᏍᎬᎢ	Other	ᎤᎵᏍᏆᏗᏍᎬᎢ:Earache
ᎠᎩᎵᏏ	Other	ᎤᎵᏏ:Grandmother
ᎠᎩᎶᎢ	Habitual	ᎤᎩᎳ:Horse (on a)
ᎠᎩᎶᎩ	Other	ᎤᎶᎩ:Father's sister
ᎠᎩᎸᎢ	Other	ᎤᎸᎢ:Sister's sister
ᎠᎩᎸᎥᎦ	Immediate	ᎠᎩᎸᎥᏍᎦ:Mounting it	ᎤᎩᎳ:Horse (on a)
ᎠᎩᎸᎥᏍᎦ	PresentContinous	ᎠᎩᎸᎥᏍᎦ:Mounting it
ᎠᎩᎸᎥᏍᎪᎢ	Habitual	ᎠᎩᎸᎥᏍᎦ:Mounting it
ᎠᎩᎸᏅᎢ	RemotePast	ᎤᎩᎳ:Horse (on a)	ᎠᎩᎸᎥᏍᎦ:Mounting it
ᎠᎩᎸᏗ	Deverbal	ᎠᎩᎸᎥᏍᎦ:Mounting it	ᎤᎩᎳ:Horse (on a)
ᎠᎩᎾᏥ	Other	ᎤᎾᏥ:Parent-in-law
ᎠᎩᏁᎦᎸᎢ	Other	ᎤᏁᎦᎸᎢ:Skin
ᎠᎩᏂᎵ	Other	ᎤᏂᎵ:Brother's older brother
ᎠᎩᏂᏏ	Other	ᎤᏂᏏ:Grandson
ᎠᎩᏄᏥ	Other	ᎤᏄᏥ:Brother's younger brother
ᎠᎩᏇᏓᎸᎢ	Other	ᎤᏇᏓᎸᎢ:Flesh
ᎠᎩᏍᏇᏅᎯ	Other	ᎤᏍᏇᏅᎯ:Fist
ᎠᎩᏍᏓᎸᎢ	Other	ᎤᏍᏓᎸᎢ:Clan
ᎠᎩᏍᏗᏳ	Other	ᎤᏍᏗᏳ:Place to look
ᎠᎩᏙ	Other	ᎤᏙ:Sister's brother (female ego)
ᎠᎩᏙᎯ	Other	ᎤᏙᎯ:Brother's sister (male ego)
ᎠᎩᏙᏓ	Other	ᎤᏙᏓ:Father's borther
ᎠᎩᏚᏚ	Other	ᎤᏚᏚ:Mother's father
ᎠᎩᏚᏥ	Other	ᎤᏚᏥ:Uncle
ᎠᎩᏥ	Other	ᎤᏥ:Mother
ᎠᎩᏦᎢ	Other	ᎤᏦᎢ:Daughter-in-law
ᎠᎩᏨᎬ	Other	ᎤᏨᎬ:Sickness
ᎠᎩᏫᎾ	Other	ᎤᏫᎾ:Brother's sister's son
ᎠᎩᏯᎶᏘᎭ	Other	ᎠᎩᏯᎶᏘᎭ:Overeat
ᎠᎩᏰᎯ	Other	ᎤᏰᎯ:Husband
ᎠᎩᏰᏑᎧᎸᎢ	Other	ᎤᏰᏑᎧᎸᎢ:Fingernail
ᎠᎩᏰᏑᏨᏂ	Other	ᎤᏰᏑᏨᏂ:Wrist
ᎠᎩᏲᎢ	Other	ᎤᏲᎢ:Bad
ᎠᎩᏲᏃᎪᏍᏓᎯ	Other	ᎤᏲᏃᎪᏍᏓᎯ:Bruise, to have a
ᎠᎩᏳᏍᏆᏗᏍᎬᎢ	Other	ᎤᏳᏍᏆᏗᏍᎬᎢ:Toothache
ᎠᎩᏴᎰᏒᎯ	Other	ᎤᏴᎰᏒᎯ:Corpse
ᎠᎪᎲᎦ	Immediate	ᎠᎪᎲᏍᎦ:Burning
ᎠᎪᎲᏍᎦ	PresentContinous	ᎠᎪᎲᏍᎦ:Burning
ᎠᎪᎲᏍᎪᎢ	Habitual	ᎠᎪᎲᏍᎦ:Burning up
ᎠᎪᎲᏍᏓ	Immediate	ᎠᎪᎲᏍᏗᎭ:Burning it
ᎠᎪᎲᏍᏓᏅᎢ	RemotePast	ᎠᎪᎲᏍᏗᎭ:Burning it
ᎠᎪᎲᏍᏗ	Deverbal	ᎠᎪᎲᏍᎦ:Burning
ᎠᎪᎲᏍᏗᎭ	PresentContinous	ᎠᎪᎲᏍᏗᎭ:Burning it
ᎠᎪᎲᏍᏗᏍᎪᎢ	Habitual	ᎠᎪᎲᏍᏗᎭ:Burning it
ᎠᎪᎲᏍᏚᏗ	Deverbal	ᎠᎪᎲᏍᏗᎭ:Burning it
ᎠᎪᎸᎠ	PresentContinous	ᎠᎪᎸᎠ:Going then turning and coming back
ᎠᎪᎸᎾ	Immediate	ᎠᎪᎸᎠ:Going then turning and coming back
ᎠᎪᎸᏍᎪᎢ	Habitual	ᎠᎪᎸᎠ:Going then turning and coming back
ᎠᎪᎸᏍᏗ	Deverbal	ᎠᎪᎸᎠ:Going then turning and coming back
ᎠᎪᎸᏒᎢ	RemotePast	ᎠᎪᎸᎠ:Going then turning and coming back
ᎠᎪᎾ	Other	ᎠᎪᎾ:Starvation	ᎠᎪᎲᏍᎦ:Burning up
ᎠᎪᏅᎢ	RemotePast	ᎠᎪᎲᏍᎦ:Burning up
ᎠᎪᏍᏓ	Immediate	ᎦᎪᏍᏗᎭ:Sifting
ᎠᎪᏍᏓᎩᏍᏗ	Other	ᎠᎪᏍᏓᎩᏍᏗ:Lettuce
ᎠᎪᏍᏔᏅᎢ	RemotePast	ᎦᎪᏍᏗᎭ:Sifting
ᎠᎪᏍᏗ	Other	ᎠᎪᏍᏗ:Unripe
ᎠᎪᏍᏗᎭ	PresentContinous	ᎦᎪᏍᏗᎭ:Sifting
ᎠᎪᏍᏗᏍᎪᎢ	Habitual	ᎦᎪᏍᏗᎭ:Sifting
ᎠᎪᏍᏙᏗ	Deverbal	ᎦᎪᏍᏗᎭ:Sifting
ᎠᎪᏍᏚᎩᏍᏗ	Other	ᎠᎪᏍᏚᎩᏍᏗ:Genus: Saxifraga Micranthidifolia
ᎠᎪᏕᎯ	Other	ᎠᎪᏕᎯ:Marsh hawk
ᎠᎪᏮ	Other	ᎠᎪᏮ:Sand piper
ᎠᎫᏍᎨᏂ	Other	ᎠᎫᏍᎨᏂ:Elbow
ᎠᎬᎭᎴᏫᏓ	Other	ᎠᎬᎭᎴᏫᏓ:Quilt top
ᎠᎬᎯᏓ	Other	ᎠᎬᎯᏓ:Sheet
ᎠᎬᏃᎨᏂ	Other	ᎠᎬᏃᎨᏂ:Wing
ᎠᎬᏍᏉᎠ	PresentContinous	ᎠᎬᏍᏉᎠ:Washing his face
ᎠᎬᏍᏉᎥᎢ	RemotePast	ᎠᎬᏍᏉᎠ:Washing his face
ᎠᎬᏍᏉᏍᎪᎢ	Habitual	ᎠᎬᏍᏉᎠ:Washing his face
ᎠᎬᏍᏉᏍᏗ	Deverbal	ᎠᎬᏍᏉᎠ:Washing his face
ᎠᎬᏍᏉᏣ	Immediate	ᎠᎬᏍᏉᎠ:Washing his face
ᎠᎬᏗᎨᏂ	Other	ᎠᎬᏗᎨᏂ:Forehead
ᎠᎬᏚᎶ	Other	ᎠᎬᏚᎶ:Mask
ᎠᎬᏩᎶᏓ	Immediate	ᎠᎬᏩᎶᏗ:With worth
ᎠᎬᏩᎶᏕᏍᏛᎢ	RemotePast	ᎠᎬᏩᎶᏗ:With worth
ᎠᎬᏩᎶᏗ	PresentContinous	ᎠᎬᏩᎶᏗ:With worth
ᎠᎬᏩᎶᏙᎢ	Habitual	ᎠᎬᏩᎶᏗ:With worth
ᎠᎬᏩᎶᏙᏗ	Deverbal	ᎠᎬᏩᎶᏗ:With worth
ᎠᎬᏱ	Other	ᎠᎬᏱ:Initially
ᎠᎬᏱᏗᏣ	Other	ᎠᎬᏱᏗᏣ:Way (in the)
ᎠᎬᏴᎵᎨᎢ	Other	ᎠᎬᏴᎵᎨᎢ:Old (something alive)
ᎠᎭᎨᏨᎯ	Other	ᎠᎭᎨᏨᎯ:Peel
ᎠᎭᏫᏯ	Other	ᎠᎭᏫᏯ:Venison
ᎠᎰᎵ	Other	ᎠᎰᎵ:Mouth
ᎠᎱᎵ	Other	ᎠᎱᎵ:Drum
ᎠᎱᏣᏬᎳᏛᎢ	Other	ᎠᎱᏣᏬᎳᏛᎢ:Chimney
ᎠᎲᎦ	Immediate	ᎠᎲᏍᎦ:Setting it
ᎠᎲᏍᎦ	PresentContinous	ᎠᎲᏍᎦ:Setting it
ᎠᎲᏍᎪᎢ	Habitual	ᎠᎲᏍᎦ:Setting it
ᎠᎳᏍᎬᎠ	PresentContinous	ᎠᎳᏍᎬᎠ:Stepping
ᎠᎳᏍᎬᎾ	Immediate	ᎠᎳᏍᎬᎠ:Stepping
ᎠᎳᏍᎬᏍᎪᎢ	Habitual	ᎠᎳᏍᎬᎠ:Stepping
ᎠᎳᏍᎬᏍᏗ	Deverbal	ᎠᎳᏍᎬᎠ:Stepping
ᎠᎳᏍᎬᏒᎢ	RemotePast	ᎠᎳᏍᎬᎠ:Stepping
ᎠᎳᏍᏛᎥᎦ	Immediate	ᎠᎳᏍᏛᎥᏍᎦ:Stepping on it
ᎠᎳᏍᏛᎥᏍᎦ	PresentContinous	ᎠᎳᏍᏛᎥᏍᎦ:Stepping on it
ᎠᎳᏍᏛᎥᏍᎪᎢ	Habitual	ᎠᎳᏍᏛᎥᏍᎦ:Stepping on it
ᎠᎳᏍᏛᏅᎢ	RemotePast	ᎠᎳᏍᏛᎥᏍᎦ:Stepping on it
ᎠᎳᏍᏛᏗ	Deverbal	ᎠᎳᏍᏛᎥᏍᎦ:Stepping on it
ᎠᎳᏑᎳᎦ	Immediate	ᏓᎳᏑᎳᏍᎦ:Putting on a shoe	ᏓᎳᏑᎳᎩᎠ:Taking off a shoe
ᎠᎳᏑᎳᎩᎠ	PresentContinous	ᏓᎳᏑᎳᎩᎠ:Taking off a shoe
ᎠᎳᏑᎳᎩᏍᎪᎢ	Habitual	ᏓᎳᏑᎳᎩᎠ:Taking off a shoe
ᎠᎳᏑᎳᎩᏍᏗ	Deverbal	ᏓᎳᏑᎳᎩᎠ:Taking off a shoe
ᎠᎳᏑᎳᎩᏒᎢ	RemotePast	ᏓᎳᏑᎳᎩᎠ:Taking off a shoe
ᎠᎳᏑᎳᏅᎢ	RemotePast	ᏓᎳᏑᎳᏍᎦ:Putting on a shoe
ᎠᎳᏑᎳᏍᎦ	PresentContinous	ᏓᎳᏑᎳᏍᎦ:Putting on a shoe
ᎠᎳᏑᎳᏍᎪᎢ	Habitual	ᏓᎳᏑᎳᏍᎦ:Putting on a shoe
ᎠᎳᏑᎳᏗ	Deverbal	ᏓᎳᏑᎳᏍᎦ:Putting on a shoe
ᎠᎳᏫᏓ	Immediate	ᎠᎳᏫᏗᎭ:Flying
ᎠᎳᏫᏗᎭ	PresentContinous	ᎠᎳᏫᏗᎭ:Flying
ᎠᎳᏫᏗᏍᎪᎢ	Habitual	ᎠᎳᏫᏗᎭ:Flying
ᎠᎳᏫᏘᏗ	Deverbal	ᎠᎳᏫᏗᎭ:Flying
ᎠᎳᏫᏛᎲᎢ	RemotePast	ᎠᎳᏫᏗᎭ:Flying
ᎠᎴ	Other	ᎠᎴ:Or
ᎠᎴᎲᎦ	Immediate	ᏓᎴᎲᏍᎦ:Rising from sitting
ᎠᎴᎲᏍᎦ	PresentContinous	ᏓᎴᎲᏍᎦ:Rising from sitting
ᎠᎴᎲᏍᎪᎢ	Habitual	ᏓᎴᎲᏍᎦ:Rising from sitting
ᎠᎴᏅᎢ	RemotePast	ᏓᎴᎲᏍᎦ:Rising from sitting
ᎠᎴᏅᏓ	Immediate	ᎠᎴᏅᏗᎭ:Beginning with
ᎠᎴᏅᏔᏅᎢ	RemotePast	ᎠᎴᏅᏗᎭ:Beginning with
ᎠᎴᏅᏗᎭ	PresentContinous	ᎠᎴᏅᏗᎭ:Beginning with
ᎠᎴᏅᏗᏍᎪᎢ	Habitual	ᎠᎴᏅᏗᎭ:Beginning with
ᎠᎴᏅᏙᏗ	Deverbal	ᎠᎴᏅᏗᎭ:Beginning with
ᎠᎴᏩ	Immediate	ᎠᎴᏫᎠ:Starting
ᎠᎴᏫᎠ	PresentContinous	ᎠᎴᏫᎠ:Starting
ᎠᎴᏫᏍᎪᎢ	Habitual	ᎠᎴᏫᎠ:Starting
ᎠᎴᏫᏗ	Deverbal	ᎠᎴᏫᎠ:Starting
ᎠᎴᏮᎥᎢ	RemotePast	ᎠᎴᏫᎠ:Starting
ᎠᎵᎡᏍᎫᏩᎲᎢ	RemotePast	ᎠᎵᏍᎫᏩᏍᎦ:Shaking his head yes
ᎠᎵᎡᏍᎫᏩᏍᎪᎢ	Habitual	ᎠᎵᏍᎫᏩᏍᎦ:Shaking his head yes
ᎠᎵᎢ	Other	ᎠᎵᎢ:Friend
ᎠᎵᎦ	Immediate	ᎠᎵᎭ:Fighting
ᎠᎵᎪᎭ	PresentContinous	ᎤᎵᎪᎭ:Belonging to a group
ᎠᎵᎪᎰᎢ	Habitual	ᎤᎵᎪᎭ:Belonging to a group
ᎠᎵᎪᎲᎦ	Immediate	ᎤᎵᎪᎭ:Belonging to a group
ᎠᎵᎪᏅᎢ	RemotePast	ᎤᎵᎪᎭ:Belonging to a group
ᎠᎵᎪᏗ	Deverbal	ᎤᎵᎪᎭ:Belonging to a group
ᎠᎵᎬᏯ	Immediate	ᎠᎵᎬᏯᏍᎦ:Diving
ᎠᎵᎬᏯᏍᎦ	PresentContinous	ᎠᎵᎬᏯᏍᎦ:Diving
ᎠᎵᎬᏯᏍᎪᎢ	Habitual	ᎠᎵᎬᏯᏍᎦ:Diving
ᎠᎵᎬᏯᏍᏗ	Deverbal	ᎠᎵᎬᏯᏍᎦ:Diving
ᎠᎵᎬᏴᎢ	RemotePast	ᎠᎵᎬᏯᏍᎦ:Diving
ᎠᎵᎭ	PresentContinous	ᎠᎵᎭ:Fighting
ᎠᎵᎮᎵᎦ	Immediate	ᎠᎵᎮᎵᎦ:Happy
ᎠᎵᎮᎵᎪᎢ	Habitual	ᎠᎵᎮᎵᎦ:Happy
ᎠᎵᎮᎵᏍᏗ	Deverbal	ᎠᎵᎮᎵᎦ:Happy
ᎠᎵᎮᎵᏨᎢ	RemotePast	ᎠᎵᎮᎵᎦ:Happy
ᎠᎵᎰᎢ	Habitual	ᎠᎵᎭ:Fighting
ᎠᎵᎷᎨᎲᎢ	RemotePast	ᏓᎵᎷᎨᏍᎦ:Rocking a chair
ᎠᎵᎷᎨᏍᎦ	PresentContinous	ᏓᎵᎷᎨᏍᎦ:Rocking a chair
ᎠᎵᎷᎨᏍᎪᎢ	Habitual	ᏓᎵᎷᎨᏍᎦ:Rocking a chair
ᎠᎵᎷᎨᏗ	Deverbal	ᏓᎵᎷᎨᏍᎦ:Rocking a chair
ᎠᎵᎷᎬᎳ	Immediate	ᏓᎵᎷᎨᏍᎦ:Rocking a chair
ᎠᎵᎸᎢ	RemotePast	ᎠᎵᎭ:Fighting
ᎠᎵᎾᏒᏍᏓ	Immediate	ᏓᎵᎾᏒᏍᏗᎭ:Skating
ᎠᎵᎾᏒᏍᏓᏅᎢ	RemotePast	ᏓᎵᎾᏒᏍᏗᎭ:Skating
ᎠᎵᎾᏒᏍᏗᎭ	PresentContinous	ᏓᎵᎾᏒᏍᏗᎭ:Skating
ᎠᎵᎾᏒᏍᏗᏍᎪᎢ	Habitual	ᏓᎵᎾᏒᏍᏗᎭ:Skating
ᎠᎵᎾᏒᏍᏙᏗ	Deverbal	ᏓᎵᎾᏒᏍᏗᎭ:Skating
ᎠᎵᏂᏆᏅᎥᎦ	Immediate	ᏓᎵᏂᏆᏅᎥᏍᎦ:Kneeling
ᎠᎵᏂᏆᏅᎥᏍᎦ	PresentContinous	ᏓᎵᏂᏆᏅᎥᏍᎦ:Kneeling
ᎠᎵᏂᏆᏅᎥᏍᎪᎢ	Habitual	ᏓᎵᏂᏆᏅᎥᏍᎦ:Kneeling
ᎠᎵᏂᏆᏅᏅᎢ	RemotePast	ᏓᎵᏂᏆᏅᎥᏍᎦ:Kneeling
ᎠᎵᏂᏆᏅᏗ	Deverbal	ᏓᎵᏂᏆᏅᎥᏍᎦ:Kneeling
ᎠᎵᏃᎥᎳ	Immediate	ᏓᎵᏃᎮᎭ:Telephoning
ᎠᎵᏃᎮᎭ	PresentContinous	ᏓᎵᏃᎮᎭ:Telephoning
ᎠᎵᏃᎮᎸᎢ	RemotePast	ᏓᎵᏃᎮᎭ:Telephoning
ᎠᎵᏃᎮᏍᎪᎢ	Habitual	ᏓᎵᏃᎮᎭ:Telephoning
ᎠᎵᏃᎮᏗ	Deverbal	ᏓᎵᏃᎮᎭ:Telephoning
ᎠᎵᏇᏅᏗ	Other	ᎠᎵᏇᏅᏗ:Bed cover
ᎠᎵᏍᎦ	Immediate	ᎠᎵᏍᎩᎠ:Dancing
ᎠᎵᏍᎦᏗ	Other	ᎠᎵᏍᎦᏗ:Ball
ᎠᎵᏍᎩᎠ	PresentContinous	ᎠᎵᏍᎩᎠ:Dancing
ᎠᎵᏍᎩᏍᎪᎢ	Habitual	ᎠᎵᏍᎩᎠ:Dancing
ᎠᎵᏍᎩᏍᏗ	Deverbal	ᎠᎵᏍᎩᎠ:Dancing
ᎠᎵᏍᎩᏒᎢ	RemotePast	ᎠᎵᏍᎩᎠ:Dancing
ᎠᎵᏍᎫᏩ	Immediate	ᎠᎵᏍᎫᏩᏍᎦ:Shaking his head yes
ᎠᎵᏍᎫᏩᏍᎦ	PresentContinous	ᎠᎵᏍᎫᏩᏍᎦ:Shaking his head yes
ᎠᎵᏍᎫᏩᏍᏗ	Deverbal	ᎠᎵᏍᎫᏩᏍᎦ:Shaking his head yes
ᎠᎵᏍᏆᎵᏒᎠᎦ	Immediate	ᏚᎵᏍᏆᎵᏒᎯᎠ:Broke
ᎠᎵᏍᏆᎵᏒᎯᎠ	PresentContinous	ᏚᎵᏍᏆᎵᏒᎯᎠ:Broke
ᎠᎵᏍᏆᎵᏒᏍᎪᎢ	Habitual	ᏚᎵᏍᏆᎵᏒᎯᎠ:Broke
ᎠᎵᏍᏆᎵᏒᏍᏗ	Deverbal	ᏚᎵᏍᏆᎵᏒᎯᎠ:Broke
ᎠᎵᏍᏆᎵᏒᏒᎢ	RemotePast	ᏚᎵᏍᏆᎵᏒᎯᎠ:Broke
ᎠᎵᏍᏓᏴᎤᎦ	Immediate	ᎠᎵᏍᏓᏴᏅᏍᎦ:Going to eat
ᎠᎵᏍᏓᏴᎲᎦ	Immediate	ᎠᎵᏍᏓᏴᎲᏍᎦ:Eating a meal
ᎠᎵᏍᏓᏴᎲᏍᎦ	PresentContinous	ᎠᎵᏍᏓᏴᎲᏍᎦ:Eating a meal
ᎠᎵᏍᏓᏴᎲᏍᎪᎢ	Habitual	ᎠᎵᏍᏓᏴᎲᏍᎦ:Eating a meal
ᎠᎵᏍᏓᏴᏅᎢ	RemotePast	ᎠᎵᏍᏓᏴᎲᏍᎦ:Eating a meal
ᎠᎵᏍᏓᏴᏅᏍᎦ	PresentContinous	ᎠᎵᏍᏓᏴᏅᏍᎦ:Going to eat
ᎠᎵᏍᏓᏴᏅᏍᎪᎢ	Habitual	ᎠᎵᏍᏓᏴᏅᏍᎦ:Going to eat
ᎠᎵᏍᏓᏴᏅᏍᏗ	Deverbal	ᎠᎵᏍᏓᏴᏅᏍᎦ:Going to eat
ᎠᎵᏍᏓᏴᏅᏒᎢ	RemotePast	ᎠᎵᏍᏓᏴᏅᏍᎦ:Going to eat
ᎠᎵᏍᏓᏴᏗ	Deverbal	ᎠᎵᏍᏓᏴᎲᏍᎦ:Eating a meal
ᎠᎵᏍᏗ	Deverbal	ᎠᎵᎭ:Fighting
ᎠᎵᏍᏙᏯᏙᏗ	Other	ᎠᎵᏍᏙᏯᏙᏗ:Razor
ᎠᎵᏍᏚᎳ	Immediate	ᎠᎵᏍᏚᎵᎭ:Washing hair
ᎠᎵᏍᏚᎴᎲᎢ	RemotePast	ᎠᎵᏍᏚᎵᎭ:Washing hair
ᎠᎵᏍᏚᎵᎭ	PresentContinous	ᎠᎵᏍᏚᎵᎭ:Washing hair
ᎠᎵᏍᏚᎵᏍᎪᎢ	Habitual	ᎠᎵᏍᏚᎵᎭ:Washing hair
ᎠᎵᏍᏚᎵᏗ	Deverbal	ᎠᎵᏍᏚᎵᎭ:Washing hair
ᎠᎵᏍᏚᎶᎯ	Other	ᎠᎵᏍᏚᎶᎯ:Scarf
ᎠᎵᏍᏛᎦ	PresentContinous	ᎠᎵᏍᏛ&lt;n&gt;Ꭶ:Jumping
ᎠᎵᏍᏛᎪᎢ	Habitual	ᎠᎵᏍᏛ&lt;n&gt;Ꭶ:Jumping
ᎠᎵᏍᏛᎲᏗ	Deverbal	ᎠᎵᏍᏛ&lt;n&gt;Ꭶ:Jumping
ᎠᎵᏍᏛᏂᎦ	Immediate	ᎠᎵᏍᏛᏂᎭ:Shaking his head no
ᎠᎵᏍᏛᏂᎭ	PresentContinous	ᎠᎵᏍᏛᏂᎭ:Shaking his head no
ᎠᎵᏍᏛᏂᎰᎢ	Habitual	ᎠᎵᏍᏛᏂᎭ:Shaking his head no
ᎠᎵᏍᏛᏂᎸᎢ	RemotePast	ᎠᎵᏍᏛᏂᎭ:Shaking his head no
ᎠᎵᏍᏛᏂᏍᏗ	Deverbal	ᎠᎵᏍᏛᏂᎭ:Shaking his head no
ᎠᎵᏍᏛᏒᎢ	RemotePast	ᎠᎵᏍᏛ&lt;n&gt;Ꭶ:Jumping
ᎠᎵᏎᎭ	PresentContinous	ᎠᎵᏎᎭ:Carrying on his back
ᎠᎵᏎᎰᎢ	Habitual	ᎠᎵᏎᎭ:Carrying on his back
ᎠᎵᏎᏒᎢ	RemotePast	ᎠᎵᏎᎭ:Carrying on his back
ᎠᎵᏏᏂᏓ	Immediate	ᎠᎵᏏᏂᏗᎭ:Conserving
ᎠᎵᏏᏂᏓᏅᎢ	RemotePast	ᎠᎵᏏᏂᏗᎭ:Conserving
ᎠᎵᏏᏂᏗᎭ	PresentContinous	ᎠᎵᏏᏂᏗᎭ:Conserving
ᎠᎵᏏᏂᏗᏍᎪᎢ	Habitual	ᎠᎵᏏᏂᏗᎭ:Conserving
ᎠᎵᏏᏂᏙᏗ	Deverbal	ᎠᎵᏏᏂᏗᎭ:Conserving
ᎠᎵᏑᎦ	Immediate	ᎠᎵᏎᎭ:Carrying on his back
ᎠᎵᏒᏍᏗ	Deverbal	ᎠᎵᏎᎭ:Carrying on his back
ᎠᎵᏔᎹ	Other	ᎠᎵᏔᎹ:Genus: Thryothorus Lodovt
ᎠᎵᏔᏁᎭ	PresentContinous	ᎤᎵᏔᏁᎭ:Eager
ᎠᎵᏔᏁᎰᎢ	Habitual	ᎤᎵᏔᏁᎭ:Eager
ᎠᎵᏔᏁᎸᎢ	RemotePast	ᎤᎵᏔᏁᎭ:Eager
ᎠᎵᏔᏅᏗ	Deverbal	ᎤᎵᏔᏁᎭ:Eager
ᎠᎵᏔᏌ	Immediate	ᎤᎵᏔᏁᎭ:Eager
ᎠᎵᏔᏕᎦ	PresentContinous	ᎠᎵᏔᏕᎦ:Jumping	ᏓᎵᏔᏕᎦ:Jumping up and down (*u.?ka)
ᎠᎵᏔᏕᎪᎢ	Habitual	ᏓᎵᏔᏕᎦ:Jumping up and down (*u.?ka)	ᎠᎵᏔᏕᎦ:Jumping
ᎠᎵᏔᏕᏒᎢ	RemotePast	ᎠᎵᏔᏕᎦ:Jumping	ᏓᎵᏔᏕᎦ:Jumping up and down (*u.?ka)
ᎠᎵᏔᏛᎢ	Deverbal	ᎠᎵᏔᏕᎦ:Jumping
ᎠᎵᏖᎸᏂᎦ	Immediate	ᎠᎵᏖᎸᏂᎭ:Swinging
ᎠᎵᏖᎸᏂᎭ	PresentContinous	ᎠᎵᏖᎸᏂᎭ:Swinging
ᎠᎵᏖᎸᏂᎰᎢ	Habitual	ᎠᎵᏖᎸᏂᎭ:Swinging
ᎠᎵᏖᎸᏂᎸᎢ	RemotePast	ᎠᎵᏖᎸᏂᎭ:Swinging
ᎠᎵᏖᎸᏂᏍᏗ	Deverbal	ᎠᎵᏖᎸᏂᎭ:Swinging
ᎠᎵᏗᎩᎠ	PresentContinous	ᎠᎵᏗᎩᎠ:Taking off running
ᎠᎵᏗᎩᏍᎪᎢ	Habitual	ᎠᎵᏗᎩᎠ:Taking off running
ᎠᎵᏗᎩᏍᏗ	Deverbal	ᎠᎵᏗᎩᎠ:Taking off running
ᎠᎵᏗᎩᏒᎢ	RemotePast	ᎠᎵᏗᎩᎠ:Taking off running
ᎠᎵᏘᎾᎠ	PresentContinous	ᏚᎵᏘᎾᎠ:Has a family (*v?v?ka)
ᎠᎵᏘᎾᎣᎢ	Habitual	ᏚᎵᏘᎾᎠ:Has a family (*v?v?ka)
ᎠᎵᏘᏅᏅᎢ	RemotePast	ᏚᎵᏘᎾᎠ:Has a family (*v?v?ka)
ᎠᎵᏘᏅᏗ	Deverbal	ᏚᎵᏘᎾᎠ:Has a family (*v?v?ka)
ᎠᎵᏙᎩᏯ	Immediate	ᎠᎵᏙᎩᏱᎠ:Racing
ᎠᎵᏙᎩᏯᏍᏗ	Deverbal	ᎠᎵᏙᎩᏱᎠ:Racing
ᎠᎵᏙᎩᏱᎠ	PresentContinous	ᎠᎵᏙᎩᏱᎠ:Racing
ᎠᎵᏙᎩᏱᏍᎪᎢ	Habitual	ᎠᎵᏙᎩᏱᎠ:Racing
ᎠᎵᏙᎩᏱᏒᎢ	RemotePast	ᎠᎵᏙᎩᏱᎠ:Racing
ᎠᎵᏣ	Immediate	ᎠᎵᏥᎭ:Boiling
ᎠᎵᏣᏃᏍᎦ	Other	ᎠᎵᏣᏃᏍᎦ:Indigo bunting
ᎠᎵᏥᎭ	PresentContinous	ᎠᎵᏥᎭ:Boiling
ᎠᎵᏥᏍᎪᎢ	Habitual	ᎠᎵᏥᎭ:Boiling
ᎠᎵᏥᏍᏆ	Immediate	ᎠᎵᏥᏍᏈᏍᎦ:Spitting
ᎠᎵᏥᏍᏈᏍᎦ	PresentContinous	ᎠᎵᏥᏍᏈᏍᎦ:Spitting
ᎠᎵᏥᏍᏈᏍᎪᎢ	Habitual	ᎠᎵᏥᏍᏈᏍᎦ:Spitting
ᎠᎵᏥᏍᏈᏍᏗ	Deverbal	ᎠᎵᏥᏍᏈᏍᎦ:Spitting
ᎠᎵᏥᏍᏋᎢ	RemotePast	ᎠᎵᏥᏍᏈᏍᎦ:Spitting
ᎠᎵᏥᏓ	Immediate	ᎠᎵᏥᏗᎭ:Boiling it
ᎠᎵᏥᏓᏅᎢ	RemotePast	ᎠᎵᏥᏗᎭ:Boiling it
ᎠᎵᏥᏗᎭ	PresentContinous	ᎠᎵᏥᏗᎭ:Boiling it
ᎠᎵᏥᏗᏍᎪᎢ	Habitual	ᎠᎵᏥᏗᎭ:Boiling it
ᎠᎵᏥᏙᎲᎦ	Immediate	ᎠᎵᏥᏙᎲᏍᎦ:Preaching
ᎠᎵᏥᏙᎲᏍᎦ	PresentContinous	ᎠᎵᏥᏙᎲᏍᎦ:Preaching
ᎠᎵᏥᏙᎲᏍᎩ	Other	ᎠᎵᏥᏙᎲᏍᎩ:Preacher
ᎠᎵᏥᏙᎲᏍᎪᎢ	Habitual	ᎠᎵᏥᏙᎲᏍᎦ:Preaching
ᎠᎵᏥᏙᏅᎢ	RemotePast	ᎠᎵᏥᏙᎲᏍᎦ:Preaching
ᎠᎵᏥᏙᏗ	Deverbal	ᎠᎵᏥᏗᎭ:Boiling it	ᎠᎵᏥᏙᎲᏍᎦ:Preaching
ᎠᎵᏨᎯᎥᎢ	RemotePast	ᎠᎵᏥᎭ:Boiling
ᎠᎵᏨᏗ	Deverbal	ᎠᎵᏥᎭ:Boiling
ᎠᎵᏯᎦ	Immediate	ᏓᎵᏯᎩᎠ:Taking off a sock
ᎠᎵᏯᎩᎠ	PresentContinous	ᏓᎵᏯᎩᎠ:Taking off a sock
ᎠᎵᏯᎩᏍᎪᎢ	Habitual	ᏓᎵᏯᎩᎠ:Taking off a sock
ᎠᎵᏯᎩᏍᏗ	Deverbal	ᏓᎵᏯᎩᎠ:Taking off a sock
ᎠᎵᏯᎩᏒᎢ	RemotePast	ᏓᎵᏯᎩᎠ:Taking off a sock
ᎠᎵᏰᎲᎦ	Immediate	ᎠᎵᏰᎲᏍᎦ:Sprouting (a plant)
ᎠᎵᏰᎲᏍᎦ	PresentContinous	ᎠᎵᏰᎲᏍᎦ:Sprouting (a plant)
ᎠᎵᏰᎲᏍᎪᎢ	Habitual	ᎠᎵᏰᎲᏍᎦ:Sprouting (a plant)
ᎠᎵᏰᎴᏒᎢ	RemotePast	ᎠᎵᏰᎵ:Moving himself
ᎠᎵᏰᎵ	PresentContinous	ᎠᎵᏰᎵ:Moving himself
ᎠᎵᏰᎵᎦ	Immediate	ᎠᎵᏰᎵ:Moving himself
ᎠᎵᏰᎵᏐᎢ	Habitual	ᎠᎵᏰᎵ:Moving himself
ᎠᎵᏰᎶᎦ	Immediate	ᎠᎵᏰᎶᏍᎦ:Come to point that intr- (??)
ᎠᎵᏰᎶᎯᏍᏗ	Deverbal	ᎠᎵᏰᎶᏍᎦ:Come to point that intr- (??)
ᎠᎵᏰᎶᎸᎢ	RemotePast	ᎠᎵᏰᎶᏍᎦ:Come to point that intr- (??)
ᎠᎵᏰᎶᏍᎦ	PresentContinous	ᎠᎵᏰᎶᏍᎦ:Come to point that intr- (??)
ᎠᎵᏰᎶᏍᎪᎢ	Habitual	ᎠᎵᏰᎶᏍᎦ:Come to point that intr- (??)
ᎠᎵᏰᎸᏍᏗ	Deverbal	ᎠᎵᏰᎵ:Moving himself
ᎠᎵᏰᏅᎢ	RemotePast	ᎠᎵᏰᎲᏍᎦ:Sprouting (a plant)
ᎠᎵᏰᏑᎶ	Other	ᎠᎵᏰᏑᎶ:Gloves
ᎠᎵᏰᏑᏍᏓᎦ	Immediate	ᎠᎵᏰᏑᏍᏓᎩᎠ:Taking off a ring
ᎠᎵᏰᏑᏍᏓᎩᎠ	PresentContinous	ᎠᎵᏰᏑᏍᏓᎩᎠ:Taking off a ring
ᎠᎵᏰᏑᏍᏓᎩᏍᎪᎢ	Habitual	ᎠᎵᏰᏑᏍᏓᎩᎠ:Taking off a ring
ᎠᎵᏰᏑᏍᏓᎩᏍᏗ	Deverbal	ᎠᎵᏰᏑᏍᏓᎩᎠ:Taking off a ring
ᎠᎵᏰᏑᏍᏓᎩᏒᎢ	RemotePast	ᎠᎵᏰᏑᏍᏓᎩᎠ:Taking off a ring
ᎠᎵᏰᏗ	Deverbal	ᎠᎵᏰᎲᏍᎦ:Sprouting (a plant)
ᎠᎵᏲᎦ	Immediate	ᏓᎵᏲᎭ:Putting on a sock
ᎠᎵᏲᎭ	PresentContinous	ᏓᎵᏲᎭ:Putting on a sock
ᎠᎵᏲᎰᎢ	Habitual	ᏓᎵᏲᎭ:Putting on a sock
ᎠᎵᏲᎸᎢ	RemotePast	ᏓᎵᏲᎭ:Putting on a sock
ᎠᎵᏲᏍᏗ	Deverbal	ᏓᎵᏲᎭ:Putting on a sock
ᎠᎵᏲᏪᏓ	Immediate	ᎠᎵᏲᏪᏗᎭ:Pouting
ᎠᎵᏲᏪᏔᏅᎢ	RemotePast	ᎠᎵᏲᏪᏗᎭ:Pouting
ᎠᎵᏲᏪᏗᎭ	PresentContinous	ᎠᎵᏲᏪᏗᎭ:Pouting
ᎠᎵᏲᏪᏗᏍᎪᎢ	Habitual	ᎠᎵᏲᏪᏗᎭ:Pouting
ᎠᎵᏲᏪᏙᏗ	Deverbal	ᎠᎵᏲᏪᏗᎭ:Pouting
ᎠᎶᎦ	Immediate	ᎠᎵᏗᎩᎠ:Taking off running
ᎠᎷᎸᎥᎦ	Immediate	ᎠᎷᎸᎥᏍᎦ:Giving birth
ᎠᎷᎸᎥᏅᎢ	RemotePast	ᎠᎷᎸᎥᏍᎦ:Giving birth
ᎠᎷᎸᎥᏍᎦ	PresentContinous	ᎠᎷᎸᎥᏍᎦ:Giving birth
ᎠᎷᎸᎥᏍᎪᎢ	Habitual	ᎠᎷᎸᎥᏍᎦ:Giving birth
ᎠᎷᎸᏗ	Deverbal	ᎠᎷᎸᎥᏍᎦ:Giving birth
ᎠᎸᎢᎭ	PresentContinous	ᎠᎸᎢᎭ:Tying up
ᎠᎸᎢᎰᎢ	Habitual	ᎠᎸᎢᎭ:Tying up
ᎠᎸᎸᎢ	RemotePast	ᎠᎸᎢᎭ:Tying up
ᎠᎸᏅᏖᎦ	Immediate	ᎤᎸᏅᏖᎭ:Fainting
ᎠᎸᏅᏖᎭ	PresentContinous	ᎤᎸᏅᏖᎭ:Fainting
ᎠᎸᏅᏖᎰᎢ	Habitual	ᎤᎸᏅᏖᎭ:Fainting
ᎠᎸᏅᏖᎸᎢ	RemotePast	ᎤᎸᏅᏖᎭ:Fainting
ᎠᎸᏅᏖᏍᏗ	Deverbal	ᎤᎸᏅᏖᎭ:Fainting
ᎠᎸᏍᏗ	Deverbal	ᎠᎸᎢᎭ:Tying up
ᎠᎸᏣ	Immediate	ᎠᎸᎢᎭ:Tying up
ᎠᎹ	Other	ᎠᎹ:Salt
ᎠᎹᎨᎢ	Other	ᎠᎹᎨᎢ:Hominy soup
ᎠᎹᎨᏴᎢ	Other	ᎠᎹᎨᏴᎢ:Creek
ᎠᎹᏱ	Other	ᎠᎹᏱ:River
ᎠᎾᎦᎳ	Immediate	ᎠᎾᎦᎵᎭ:Lightening
ᎠᎾᎦᎵᎭ	PresentContinous	ᎠᎾᎦᎵᎭ:Lightening
ᎠᎾᎦᎵᏍᎩ	Other	ᎠᎾᎦᎵᏍᎩ:Lightening
ᎠᎾᎦᎵᏍᎪᎢ	Habitual	ᎠᎾᎦᎵᎭ:Lightening
ᎠᎾᎦᎵᏗ	Deverbal	ᎠᎾᎦᎵᎭ:Lightening
ᎠᎾᎦᎸᎲᎢ	RemotePast	ᎠᎾᎦᎵᎭ:Lightening
ᎠᎾᎵᏍᏆᎸᏍᎩ	Other	ᎠᎾᎵᏍᏆᎸᏍᎩ:Genus: Dentari Diphylla
ᎠᎾᏆᏂᎩ	Other	ᎠᎾᏆᏂᎩ:Delaware Indians
ᎠᎾᏓᏌᏆᎴᎦ	Immediate	ᎠᏂᎠᏓᏌᏆᎴᎯᎭ:Rolling (they are)
ᎠᎾᏓᏍᏓᏍᎩ	Other	ᎠᎾᏓᏍᏓᏍᎩ:Violets
ᎠᎾᏓᏥ	Other	ᎠᎾᏓᏥ:Genus: Oenothera Biennis
ᎠᎾᏓᏥᎨᏗ	Deverbal	ᎠᎾᏓᏥᎩᎭ:Gathering together
ᎠᎾᏓᏥᎨᏛᎢ	RemotePast	ᎠᎾᏓᏥᎩᎭ:Gathering together
ᎠᎾᏓᏥᎩᎭ	PresentContinous	ᎠᎾᏓᏥᎩᎭ:Gathering together
ᎠᎾᏓᏥᎪᎢ	Habitual	ᎠᎾᏓᏥᎩᎭ:Gathering together
ᎠᎾᏓᏴᏔᏍᎩ	Other	ᎠᎾᏓᏴᏔᏍᎩ:Television
ᎠᎾᏔᏍᎩᏍᎩ	Other	ᎠᎾᏔᏍᎩᏍᎩ:Popcorn
ᎠᎾᏬᎠ	PresentContinous	ᏓᎾᏬᎠ:Dressing
ᎠᎾᏬᎥᎢ	RemotePast	ᏓᎾᏬᎠ:Dressing
ᎠᎾᏬᎦ	Immediate	ᎠᏂᎠᏬᎩᎠ:Undressing
ᎠᎾᏬᎩᏍᏗ	Deverbal	ᎠᏂᎠᏬᎩᎠ:Undressing
ᎠᎾᏬᎩᏒᎢ	RemotePast	ᎠᏂᎠᏬᎩᎠ:Undressing
ᎠᎾᏬᏍᎪᎢ	Habitual	ᏓᎾᏬᎠ:Dressing
ᎠᎾᏬᏍᏗ	Deverbal	ᏓᎾᏬᎠ:Dressing
ᎠᎾᏬᏣ	Immediate	ᏓᎾᏬᎠ:Dressing
ᎠᏁᎳᏓ	Immediate	ᎠᏂᎡᎳᏗᎠ:Traveling
ᎠᏁᎳᏗᏍᏗ	Deverbal	ᎠᏂᎡᎳᏗᎠ:Traveling
ᎠᏁᎳᏛᎢ	RemotePast	ᎠᏂᎡᎳᏗᎠ:Traveling
ᎠᏁᎶᎲᎦ	Immediate	ᏓᏁᎶᎲᏍᎦ:Playing a game
ᎠᏁᎶᎲᏍᎦ	PresentContinous	ᏓᏁᎶᎲᏍᎦ:Playing a game
ᎠᏁᎶᎲᏍᎪᎢ	Habitual	ᏓᏁᎶᎲᏍᎦ:Playing a game
ᎠᏁᎶᏅᎢ	RemotePast	ᏓᏁᎶᎲᏍᎦ:Playing a game
ᎠᏁᎶᏓ	Immediate	ᏓᏁᎶᏗᎭ:Playing with
ᎠᏁᎶᏔᏅᎢ	RemotePast	ᏓᏁᎶᏗᎭ:Playing with
ᎠᏁᎶᏗ	Deverbal	ᏓᏁᎶᎲᏍᎦ:Playing a game
ᎠᏁᎶᏗᎭ	PresentContinous	ᏓᏁᎶᏗᎭ:Playing with
ᎠᏁᎶᏗᏍᎪᎢ	Habitual	ᏓᏁᎶᏗᎭ:Playing with
ᎠᏁᎶᏙᏗ	Deverbal	ᏓᏁᎶᏗᎭ:Playing with
ᎠᏁᏍᎨᎲᎢ	RemotePast	ᎠᏂᎡᏍᎨᎭ:Building
ᎠᏁᏍᎨᏗ	Deverbal	ᎠᏂᎡᏍᎨᎭ:Building
ᎠᏁᏍᎬᎳ	Immediate	ᎠᏂᎡᏍᎨᎭ:Building
ᎠᏁᏍᏓ	Immediate	ᎠᏂᎡᏍᏗᎭ:Interpreting
ᎠᏁᏍᏓᏅᎢ	RemotePast	ᎠᏂᎡᏍᏗᎭ:Interpreting
ᎠᏁᏍᏙᏗ	Deverbal	ᎠᏂᎡᏍᏗᎭ:Interpreting
ᎠᏁᏣ	Other	ᎠᏁᏣ:Ball game (stickball)
ᎠᏁᏥᏓ	Immediate	ᏓᏁᏥᏗᎭ:Including
ᎠᏁᏥᏓᏅᎢ	RemotePast	ᏓᏁᏥᏗᎭ:Including
ᎠᏁᏥᏗᎭ	PresentContinous	ᏓᏁᏥᏗᎭ:Including
ᎠᏁᏥᏗᏍᎪᎢ	Habitual	ᏓᏁᏥᏗᎭ:Including
ᎠᏁᏥᏙᏗ	Deverbal	ᏓᏁᏥᏗᎭ:Including
ᎠᏁᏦᎥᎦ	Immediate	ᎠᏂᎡᏦᎥᏍᎦ:Playing ball
ᎠᏁᏦᎥᏍᎩ	Other	ᎠᏁᏦᎥᏍᎩ:Ball player
ᎠᏁᏦᏅᎢ	RemotePast	ᎠᏂᎡᏦᎥᏍᎦ:Playing ball
ᎠᏁᏦᏗ	Deverbal	ᎠᏂᎡᏦᎥᏍᎦ:Playing ball	ᎠᏁᏦᏗ:Ball game (stickball)
ᎠᏂᎠᏓᏌᏆᎴᎯᎭ	PresentContinous	ᎠᏂᎠᏓᏌᏆᎴᎯᎭ:Rolling (they are)
ᎠᏂᎠᏓᏌᏆᎴᎯᎰᎢ	Habitual	ᎠᏂᎠᏓᏌᏆᎴᎯᎭ:Rolling (they are)
ᎠᏂᎠᏬᎩᎠ	PresentContinous	ᎠᏂᎠᏬᎩᎠ:Undressing
ᎠᏂᎠᏬᎩᏍᎪᎢ	Habitual	ᎠᏂᎠᏬᎩᎠ:Undressing
ᎠᏂᎡᎳᏗᎠ	PresentContinous	ᎠᏂᎡᎳᏗᎠ:Traveling
ᎠᏂᎡᎳᏗᏍᎪᎢ	Habitual	ᎠᏂᎡᎳᏗᎠ:Traveling
ᎠᏂᎡᏍᎨᎭ	PresentContinous	ᎠᏂᎡᏍᎨᎭ:Building
ᎠᏂᎡᏍᎨᏍᎪᎢ	Habitual	ᎠᏂᎡᏍᎨᎭ:Building
ᎠᏂᎡᏍᏗᎭ	PresentContinous	ᎠᏂᎡᏍᏗᎭ:Interpreting
ᎠᏂᎡᏍᏗᏍᎪᎢ	Habitual	ᎠᏂᎡᏍᏗᎭ:Interpreting
ᎠᏂᎡᏦᎥᏍᎦ	PresentContinous	ᎠᏂᎡᏦᎥᏍᎦ:Playing ball
ᎠᏂᎡᏦᎥᏍᎪᎢ	Habitual	ᎠᏂᎡᏦᎥᏍᎦ:Playing ball
ᎠᏂᎢ	Other	ᎠᏂᎢ:Strawberry (wild or tame)
ᎠᏂᎥᏬ	Other	ᎠᏂᎥᏬ:Shirt
ᎠᏂᎦᎸᎾᏥ	Other	ᎠᏂᎦᎸᎾᏥ:Frenchmen
ᎠᏂᎧᏫ	Other	ᎠᏂᎧᏫ:Deer clan
ᎠᏂᎧᏫᏔ	Other	ᎠᏂᎧᏫᏔ:Creek (lower)
ᎠᏂᎩᎵ	Other	ᎠᏂᎩᎵ:Congaree (the dog people), see Mooney pg 508
ᎠᏂᎩᎵᏏ	Other	ᎠᏂᎩᎵᏏ:Englishmen
ᎠᏂᎩᎶᎯ	Other	ᎠᏂᎩᎶᎯ:Long hair clan (twister)
ᎠᏂᎩᏍᎩ	Other	ᎠᏂᎩᏍᎩ:People with no clan affiliation
ᎠᏂᎪᏍᏓᏯ	Other	ᎠᏂᎪᏍᏓᏯ:Genus: Chateura Pelacica
ᎠᏂᎪᏓᎨᏫ	Other	ᎠᏂᎪᏓᎨᏫ:Wild potato clan
ᎠᏂᎫᏏ	Other	ᎠᏂᎫᏏ:Creek (upper)
ᎠᏂᎬᎢᏍᏗ	Deverbal	ᎠᏂᎬᎦ:Need (in)
ᎠᏂᎬᎦ	PresentContinous	ᎠᏂᎬᎦ:Need (in)
ᎠᏂᎬᎪᎢ	Habitual	ᎠᏂᎬᎦ:Need (in)
ᎠᏂᎬᎾᎨᎢ	Other	ᎠᏂᎬᎾᎨᎢ:Black people
ᎠᏂᎬᏨᎢ	RemotePast	ᎠᏂᎬᎦ:Need (in)
ᎠᏂᏃᏥ	Other	ᎠᏂᏃᏥ:Natchez
ᎠᏂᏅᎾᏓᏪᎩ	Other	ᎠᏂᏅᎾᏓᏪᎩ:Iroquois
ᎠᏂᏆᏌᏏ	Other	ᎠᏂᏆᏌᏏ:Osage
ᎠᏂᏇᎩ	Other	ᎠᏂᏇᎩ:Quakers
ᎠᏂᏌᎰᏂ	Other	ᎠᏂᏌᎰᏂ:Blue clan
ᎠᏂᏌᏩᏄᎩ	Other	ᎠᏂᏌᏩᏄᎩ:Shawnee
ᎠᏂᏍᎦᎶᎵ	Other	ᎠᏂᏍᎦᎶᎵ:Tuscarora
ᎠᏂᏍᎦᏥ	Other	ᎠᏂᏍᎦᏥ:Scotchmen
ᎠᏂᏍᎬᏘ	Other	ᎠᏂᏍᎬᏘ:May
ᎠᏂᏍᏆᏂ	Other	ᎠᏂᏍᏆᏂ:Spaniards
ᎠᏂᏎᎻᏃᎵ	Other	ᎠᏂᏎᎻᏃᎵ:Seminole
ᎠᏂᏎᏂᎧ	Other	ᎠᏂᏎᏂᎧ:Seneca
ᎠᏂᏑᎵ	Other	ᎠᏂᏑᎵ:Jury
ᎠᏂᏑᏩᎵ	Other	ᎠᏂᏑᏩᎵ:Cheraw or sera
ᎠᏂᏒᏅᎯᏓ	Other	ᎠᏂᏒᏅᎯᏓ:Horse corn
ᎠᏂᏓᏥ	Other	ᎠᏂᏓᏥ:Germans
ᎠᏂᏔᏈ	Other	ᎠᏂᏔᏈ:Catawba
ᎠᏂᏛᎾᏗᎠ	Immediate	ᎠᏂᏛᎾᏗᎠ:Grazing
ᎠᏂᏛᎾᏗᎥᎢ	RemotePast	ᎠᏂᏛᎾᏗᎠ:Grazing
ᎠᏂᏛᎾᏗᏍᎪᎢ	Habitual	ᎠᏂᏛᎾᏗᎠ:Grazing
ᎠᏂᏛᎾᏗᏍᏗ	Deverbal	ᎠᏂᏛᎾᏗᎠ:Grazing
ᎠᏂᏣᎧᏔ	Other	ᎠᏂᏣᎧᏔ:Choctaw
ᎠᏂᏥᎧᏌ	Other	ᎠᏂᏥᎧᏌ:Chickasaw
ᎠᏂᏥᏍᏆ	Other	ᎠᏂᏥᏍᏆ:Bird clan
ᎠᏂᏩᏥᏂ	Other	ᎠᏂᏩᏥᏂ:Virginians
ᎠᏂᏩᏯ	Other	ᎠᏂᏩᏯ:Wolf clan
ᎠᏂᏬᏂᏍᎩ	Other	ᎠᏂᏬᏂᏍᎩ:Genus: Lycopus Virginicus
ᎠᏂᏬᏗ	Other	ᎠᏂᏬᏗ:Paint clan
ᎠᏂᏳᏥ	Other	ᎠᏂᏳᏥ:Yuchi
ᎠᏃᏒᎥᎦ	Immediate	ᎦᏃᏒᎥᏍᎦ:Putting on his shoulder
ᎠᏃᏒᎥᏍᎦ	PresentContinous	ᎦᏃᏒᎥᏍᎦ:Putting on his shoulder
ᎠᏃᏒᎥᏍᎪᎢ	Habitual	ᎦᏃᏒᎥᏍᎦ:Putting on his shoulder
ᎠᏃᏒᏅᎢ	RemotePast	ᎦᏃᏒᎥᏍᎦ:Putting on his shoulder
ᎠᏃᏒᏗ	Deverbal	ᎦᏃᏒᎥᏍᎦ:Putting on his shoulder
ᎠᏄᎳᏥᏴᎢ	Other	ᎠᏄᎳᏥᏴᎢ:Ribs
ᎠᏅᎢ	RemotePast	ᎠᎲᏍᎦ:Setting it
ᎠᏅᎢᏍᏗ	Deverbal	ᎤᏅᎦ:Hurrying
ᎠᏅᎦ	Immediate	ᎤᏅᎦ:Hurrying
ᎠᏅᎪᎢ	Habitual	ᎤᏅᎦ:Hurrying
ᎠᏅᏓᎭ	PresentContinous	ᎤᏅᏓᎭ:Remembering
ᎠᏅᏓᎰᎢ	Habitual	ᎤᏅᏓᎭ:Remembering
ᎠᏅᏓᏗᏍᏗ	Deverbal	ᎤᏅᏓᎭ:Remembering
ᎠᏅᏓᏛᎢ	RemotePast	ᎤᏅᏓᎭ:Remembering
ᎠᏅᏛᏓ	Immediate	ᎤᏅᏓᎭ:Remembering
ᎠᏅᏨᎢ	RemotePast	ᎤᏅᎦ:Hurrying
ᎠᏅᏱ	Other	ᎠᏅᏱ:March (month)
ᎠᏆᎦᏍᏙᎯ	Other	ᎤᎦᏍᏙᎯ:Pillow
ᎠᏆᎦᏎᏂ	Other	ᎤᎦᏎᏂ:Anus
ᎠᏆᎧᏛᎢ	Other	ᎤᎧᏛᎢ:Face
ᎠᏆᎪᏅ	Other	ᎤᎪᏅ:Testicle
ᎠᏆᎳᏏᏕᏂ	Other	ᎤᎳᏏᏕᏂ:Foot
ᎠᏆᎳᏑᎶ	Other	ᎤᎳᏑᎶ:Shoe
ᎠᏆᎴᏐᏓ	Other	ᎤᎴᏐᏓ:Skinny
ᎠᏆᎵᏍᏇᏔᏬᎯ	Other	ᎤᎵᏍᏇᏔᏬᎯ:Hat
ᎠᏆᎵᏍᏓᏴᏗ	Other	ᎤᎵᏍᏓᏴᏗ:Food
ᎠᏆᎵᏰᏑᏍᏓᏬ	Other	ᎤᎵᏰᏑᏍᏓᏬ:Ring
ᎠᏆᎵᏲᎯ	Other	ᎤᎵᏲᎯ:Sock
ᎠᏆᎸᏂᎦ	Immediate	ᎠᏆᎸᏂᎭ:Spanking him
ᎠᏆᎸᏂᎭ	PresentContinous	ᎠᏆᎸᏂᎭ:Spanking him
ᎠᏆᎸᏂᎰᎢ	Habitual	ᎠᏆᎸᏂᎭ:Spanking him
ᎠᏆᎸᏂᎸᎢ	RemotePast	ᎠᏆᎸᏂᎭ:Spanking him
ᎠᏆᎸᏂᏍᏗ	Deverbal	ᎠᏆᎸᏂᎭ:Spanking him
ᎠᏆᏅᏌᏗ	Other	ᎤᏅᏌᏗ:Rattle wrapped around the leg
ᎠᏆᏌᎴᏂ	Other	ᎤᏌᎴᏂ:Coat
ᎠᏆᏍᎦᎩ	Other	ᎤᏍᎦᎩ:Enemy
ᎠᏆᏍᏓᏁᎦᎸᎢ	Other	ᎤᏍᏓᏁᎦᎸᎢ:Sole of the foot
ᎠᏆᏑᎧᎸᎢ	Other	ᎤᏑᎧᎸᎢ:Toe nail
ᎠᏆᏓᎵᎢ	Other	ᎤᏓᎵᎢ:Wife
ᎠᏆᏓᏅᏙ	Other	ᎤᏓᏅᏙ:Heart
ᎠᏆᏘᎾᎢ	Other	ᎤᏘᎾᎢ:Father's brother's wife
ᎠᏆᏙ	Other	ᎤᏙ:Sister's daughter
ᎠᏆᏙᎵ	Other	ᎤᏙᎵ:Penis
ᎠᏆᏛᎳᎦᏍᏛᏅ	Other	ᎤᏛᎳᎦᏍᏛᏅ:Broken bone
ᎠᏆᏛᏐᏅ	Other	ᎤᏛᏐᏅ:Man, elderly
ᎠᏆᏤᎵ	Other	ᎤᏤᎵ:Possession
ᎠᏇᎳᎦᏏ	Other	ᎤᏪᎳᎦᏏ:Sibling-in-law
ᎠᏇᎷᎦ	Immediate	ᎠᏇᎷᏍᎦ:Putting a ribbon in his hair
ᎠᏇᎷᏅᎢ	RemotePast	ᎠᏇᎷᏍᎦ:Putting a ribbon in his hair
ᎠᏇᎷᏍᎦ	PresentContinous	ᎠᏇᎷᏍᎦ:Putting a ribbon in his hair
ᎠᏇᎷᏍᎪᎢ	Habitual	ᎠᏇᎷᏍᎦ:Putting a ribbon in his hair
ᎠᏇᎷᏍᏗ	Other	ᎠᏇᎷᏍᏗ:Ribbon	ᎠᏇᎷᏍᎦ:Putting a ribbon in his hair
ᎠᏇᏅᏒᎢ	Other	ᎤᏪᏅᏒᎢ:Home
ᎠᏇᏥ	Other	ᎤᏪᏥ:Offspring
ᎠᏈᏯ	Immediate	ᎠᏈᏱᎭ:Paying
ᎠᏈᏱᎭ	PresentContinous	ᎠᏈᏱᎭ:Paying
ᎠᏈᏱᏍᎪᎢ	Habitual	ᎠᏈᏱᎭ:Paying
ᎠᏈᏱᏗ	Deverbal	ᎠᏈᏱᎭ:Paying
ᎠᏈᏴᎲᎢ	RemotePast	ᎠᏈᏱᎭ:Paying
ᎠᏉᏚᎯ	Other	ᎤᏬᏚᎯ:Pretty
ᎠᏉᏰᏂ	Other	ᎤᏬᏰᏂ:Hand
ᎠᏋᏌ	Other	ᎤᏩᏌ:By oneself
ᎠᏌᎦ	Immediate	ᎠᏌᎩᎠ:Emitting body gas
ᎠᏌᎩᎠ	PresentContinous	ᎠᏌᎩᎠ:Emitting body gas
ᎠᏌᎩᏍᎪᎢ	Habitual	ᎠᏌᎩᎠ:Emitting body gas
ᎠᏌᎩᏍᏗ	Deverbal	ᎠᏌᎩᎠ:Emitting body gas
ᎠᏌᎩᏒᎢ	RemotePast	ᎠᏌᎩᎠ:Emitting body gas
ᎠᏌᏃ	Other	ᎠᏌᏃ:Woman's dress
ᎠᏍᎦᏯ	Other	ᎠᏍᎦᏯ:Man
ᎠᏍᎩᎸᎥᎦ	Immediate	ᎠᏍᎩᎸᎥᏍᎦ:Sitting on it
ᎠᏍᎩᎸᎥᏍᎦ	PresentContinous	ᎠᏍᎩᎸᎥᏍᎦ:Sitting on it
ᎠᏍᎩᎸᎥᏍᎪᎢ	Habitual	ᎠᏍᎩᎸᎥᏍᎦ:Sitting on it
ᎠᏍᎩᎸᏅᎢ	RemotePast	ᎠᏍᎩᎸᎥᏍᎦ:Sitting on it
ᎠᏍᎩᎸᏗ	Deverbal	ᎠᏍᎩᎸᎥᏍᎦ:Sitting on it
ᎠᏍᎩᎾ	Other	ᎠᏍᎩᎾ:Spirit
ᎠᏍᎩᏘᏍᎦ	Immediate	ᎠᏍᎩᏘᏍᎦ:Dreaming
ᎠᏍᎩᏘᏍᎪᎢ	Habitual	ᎠᏍᎩᏘᏍᎦ:Dreaming
ᎠᏍᎩᏘᏍᏗ	Deverbal	ᎠᏍᎩᏘᏍᎦ:Dreaming
ᎠᏍᎩᏨᎢ	RemotePast	ᎠᏍᎩᏘᏍᎦ:Dreaming
ᎠᏍᎩᏨᎥᎥᎢ	RemotePast	ᎠᏍᎩᏨᎥᏍᎦ:Dreaming of many things
ᎠᏍᎩᏨᎥᎦ	Immediate	ᎠᏍᎩᏨᎥᏍᎦ:Dreaming of many things
ᎠᏍᎩᏨᎥᏍᎦ	PresentContinous	ᎠᏍᎩᏨᎥᏍᎦ:Dreaming of many things
ᎠᏍᎩᏨᎥᏍᎪᎢ	Habitual	ᎠᏍᎩᏨᎥᏍᎦ:Dreaming of many things
ᎠᏍᎩᏨᏗ	Deverbal	ᎠᏍᎩᏨᎥᏍᎦ:Dreaming of many things
ᎠᏍᎪᎳ	Immediate	ᎠᏍᎪᏍᎦ:Digging
ᎠᏍᎪᎵ	Other	ᎠᏍᎪᎵ:Head
ᎠᏍᎪᏍᎦ	PresentContinous	ᎠᏍᎪᏍᎦ:Digging
ᎠᏍᎪᏍᎪᎢ	Habitual	ᎠᏍᎪᏍᎦ:Digging
ᎠᏍᎪᏍᏗ	Deverbal	ᎠᏍᎪᏍᎦ:Digging
ᎠᏍᎪᏒᎢ	RemotePast	ᎠᏍᎪᏍᎦ:Digging
ᎠᏍᎫᏓᏔᎦ	Immediate	ᎠᏍᎫᏓᏔᏍᎦ:Budding
ᎠᏍᎫᏓᏔᏅᎢ	RemotePast	ᎠᏍᎫᏓᏔᏍᎦ:Budding
ᎠᏍᎫᏓᏔᏍᎦ	PresentContinous	ᎠᏍᎫᏓᏔᏍᎦ:Budding
ᎠᏍᎫᏓᏔᏍᎪᎢ	Habitual	ᎠᏍᎫᏓᏔᏍᎦ:Budding
ᎠᏍᎫᏓᏙᏍᏗ	Deverbal	ᎠᏍᎫᏓᏔᏍᎦ:Budding
ᎠᏍᎬᏓᎨᏂ	Other	ᎠᏍᎬᏓᎨᏂ:Shin bone
ᎠᏍᏆᎨᏂ	Other	ᎠᏍᏆᎨᏂ:Side of a person's body
ᎠᏍᏆᏁᎦᎸᎢ	Other	ᎠᏍᏆᏁᎦᎸᎢ:Abdomen
ᎠᏍᏇᏚᏍᏗ	Other	ᎠᏍᏇᏚᏍᏗ:Cap over a stove pipe
ᎠᏍᏋᏁᏓ	Other	ᎠᏍᏋᏁᏓ:Genus: Veratum Viride
ᎠᏍᏓᏱ	Other	ᎠᏍᏓᏱ:Solid (object)
ᎠᏍᏓᏲᎭᎦ	Immediate	ᎠᏍᏓᏲᎯᎭ:Firing a gun
ᎠᏍᏓᏲᎯᎭ	PresentContinous	ᎠᏍᏓᏲᎯᎭ:Firing a gun
ᎠᏍᏓᏲᎯᎰᎢ	Habitual	ᎠᏍᏓᏲᎯᎭ:Firing a gun
ᎠᏍᏓᏲᎸᎢ	RemotePast	ᎠᏍᏓᏲᎯᎭ:Firing a gun
ᎠᏍᏓᏲᏍᏗ	Deverbal	ᎠᏍᏓᏲᎯᎭ:Firing a gun
ᎠᏍᏙᏗ	Other	ᎠᏍᏙᏗ:Door
ᎠᏍᏛᎢ	Other	ᎠᏍᏛᎢ:End
ᎠᏍᏛᎧ	PresentContinous	ᎠᏍᏛᎧ:Deep
ᎠᏍᏛᎪᎢ	Habitual	ᎠᏍᏛᎧ:Deep
ᎠᏍᏛᎲᎭ	Immediate	ᎠᏍᏛᎧ:Deep
ᎠᏍᏛᎲᏍᏗ	Deverbal	ᎠᏍᏛᎧ:Deep
ᎠᏍᏛᏒᎢ	RemotePast	ᎠᏍᏛᎧ:Deep
ᎠᏎᎵᏓᏅ	Other	ᎠᏎᎵᏓᏅ:Affadavit
ᎠᏎᏃ	Other	ᎠᏎᏃ:Probably
ᎠᏏᏁᏒᎢ	RemotePast	ᎠᏏᏂ:Going there and lying down
ᎠᏏᏂ	PresentContinous	ᎠᏏᏂ:Going there and lying down
ᎠᏏᏂᏐᎢ	Habitual	ᎠᏏᏂ:Going there and lying down
ᎠᏏᏄᎦ	Immediate	ᎠᏏᏂ:Going there and lying down
ᎠᏏᏅᏍᏗ	Deverbal	ᎠᏏᏂ:Going there and lying down
ᎠᏐᎣᎭ	Immediate	ᎠᏐᎣᏍᎦ:Falling (something long)
ᎠᏐᎣᎯᏍᏗ	Deverbal	ᎠᏐᎣᏍᎦ:Falling (something long)
ᎠᏐᎣᏍᎦ	PresentContinous	ᎠᏐᎣᏍᎦ:Falling (something long)
ᎠᏐᎣᏍᎪᎢ	Habitual	ᎠᏐᎣᏍᎦ:Falling (something long)
ᎠᏐᎣᏒᎢ	RemotePast	ᎠᏐᎣᏍᎦ:Falling (something long)
ᎠᏐᎸᏔᎦ	Immediate	ᎠᏐᎸᏔᏍᎦ:Raising an arm
ᎠᏐᎸᏔᏅᎢ	RemotePast	ᎠᏐᎸᏔᏍᎦ:Raising an arm
ᎠᏐᎸᏔᏍᎦ	PresentContinous	ᎠᏐᎸᏔᏍᎦ:Raising an arm
ᎠᏐᎸᏔᏍᎪᎢ	Habitual	ᎠᏐᎸᏔᏍᎦ:Raising an arm
ᎠᏐᎸᏘᏗ	Deverbal	ᎠᏐᎸᏔᏍᎦ:Raising an arm
ᎠᏐᏍᏗ	Other	ᎠᏐᏍᏗ:Diaper
ᎠᏐᏲᎰᎭ	Immediate	ᎠᏐᏲᎰᏍᎦ:Sliding
ᎠᏐᏲᎰᏍᎦ	PresentContinous	ᎠᏐᏲᎰᏍᎦ:Sliding
ᎠᏐᏲᎰᏍᎪᎢ	Habitual	ᎠᏐᏲᎰᏍᎦ:Sliding
ᎠᏐᏲᎰᏍᏗ	Deverbal	ᎠᏐᏲᎰᏍᎦ:Sliding
ᎠᏐᏲᎰᏒᎢ	RemotePast	ᎠᏐᏲᎰᏍᎦ:Sliding
ᎠᏑᎨᎭ	PresentContinous	ᎠᏑᎨᎭ:Stirring
ᎠᏑᎨᎲᎢ	RemotePast	ᎠᏑᎨᎭ:Stirring
ᎠᏑᎨᎸᎯ	Other	ᎠᏑᎨᎸᎯ:Batter
ᎠᏑᎨᏍᎪᎢ	Habitual	ᎠᏑᎨᎭ:Stirring
ᎠᏑᎨᏗ	Deverbal	ᎠᏑᎨᎭ:Stirring
ᎠᏑᎪᏍᏗ	Other	ᎠᏑᎪᏍᏗ:Gritter
ᎠᏑᎬᎳ	Immediate	ᎠᏑᎨᎭ:Stirring
ᎠᏑᎳᎦ	Immediate	ᎠᏑᎳᎩᎠ:Taking off a pair of pants
ᎠᏑᎳᎩᎠ	PresentContinous	ᎠᏑᎳᎩᎠ:Taking off a pair of pants
ᎠᏑᎳᎩᏍᎪᎢ	Habitual	ᎠᏑᎳᎩᎠ:Taking off a pair of pants
ᎠᏑᎳᎩᏍᏗ	Deverbal	ᎠᏑᎳᎩᎠ:Taking off a pair of pants
ᎠᏑᎳᎩᏒᎢ	RemotePast	ᎠᏑᎳᎩᎠ:Taking off a pair of pants
ᎠᏑᎳᎾ	Immediate	ᎠᏑᎵᎠ:Putting on a pair of pants
ᎠᏑᎳᏅᎢ	RemotePast	ᎠᏑᎵᎠ:Putting on a pair of pants
ᎠᏑᎴᎠ	Immediate	ᏓᏑᎴᎭ:Washing hands	ᎠᏑᎴᎭ:Wiping himself
ᎠᏑᎴᎭ	PresentContinous	ᎠᏑᎴᎭ:Wiping himself	ᏓᏑᎴᎭ:Washing hands
ᎠᏑᎴᎲᎢ	RemotePast	ᏓᏑᎴᎭ:Washing hands	ᎠᏑᎴᎭ:Wiping himself
ᎠᏑᎴᏍᎪᎢ	Habitual	ᎠᏑᎴᎭ:Wiping himself	ᏓᏑᎴᎭ:Washing hands
ᎠᏑᎴᏗ	Deverbal	ᎠᏑᎴᎭ:Wiping himself	ᏓᏑᎴᎭ:Washing hands
ᎠᏑᎴᏙᏗ	Other	ᎠᏑᎴᏙᏗ:Toilet paper
ᎠᏑᎵᎠ	PresentContinous	ᎠᏑᎵᎠ:Putting on a pair of pants
ᎠᏑᎵᏍᎪᎢ	Habitual	ᎠᏑᎵᎠ:Putting on a pair of pants
ᎠᏑᎶ	Other	ᎠᏑᎶ:Pair of pants
ᎠᏑᎶᏗ	Deverbal	ᎠᏑᎵᎠ:Putting on a pair of pants
ᎠᏑᏯᎦ	Immediate	ᏓᏑᏯᎩᎠ:Selecting
ᎠᏑᏯᎩᎠ	PresentContinous	ᏓᏑᏯᎩᎠ:Selecting
ᎠᏑᏯᎩᏍᎪᎢ	Habitual	ᏓᏑᏯᎩᎠ:Selecting
ᎠᏑᏯᎩᏍᏗ	Deverbal	ᏓᏑᏯᎩᎠ:Selecting
ᎠᏑᏯᎩᏒᎢ	RemotePast	ᏓᏑᏯᎩᎠ:Selecting
ᎠᏑᏰᎭ	PresentContinous	ᎠᏑᏰᎭ:Mixing stuff together
ᎠᏑᏰᎲᎢ	RemotePast	ᎠᏑᏰᎭ:Mixing stuff together
ᎠᏑᏰᏍᎪᎢ	Habitual	ᎠᏑᏰᎭ:Mixing stuff together
ᎠᏑᏰᏗ	Deverbal	ᎠᏑᏰᎭ:Mixing stuff together
ᎠᏑᏴᎳ	Immediate	ᎠᏑᏰᎭ:Mixing stuff together
ᎠᏒᏂᎦ	Immediate	ᎠᏒᏂᎭ:Touching it
ᎠᏒᏂᎭ	PresentContinous	ᎠᏒᏂᎭ:Touching it
ᎠᏒᏂᎰᎢ	Habitual	ᎠᏒᏂᎭ:Touching it
ᎠᏒᏂᎸᎢ	RemotePast	ᎠᏒᏂᎭ:Touching it
ᎠᏒᏂᏍᏗ	Deverbal	ᎠᏒᏂᎭ:Touching it
ᎠᏒᏓᏆᎶᏍᏗ	Other	ᎠᏒᏓᏆᎶᏍᏗ:Log
ᎠᏒᏨ	Other	ᎠᏒᏨ:Bridge
ᎠᏓ	Immediate	ᎠᏗᎠ:Saying it	ᎠᏓ:Wood
ᎠᏓᎠ	PresentContinous	ᎦᏓᎠ:Being hanged
ᎠᏓᎣᎢ	Habitual	ᎦᏓᎠ:Being hanged
ᎠᏓᎥᎥᎦ	Immediate	ᎦᏓᎠ:Being hanged
ᎠᏓᎦ	Immediate	ᎦᏓᎩᎠ:Taking down something solid, something flexible, or something alive
ᎠᏓᎦᏘᏯ	Immediate	ᎠᏓᎦᏘᏰᎭ:Baby sitting
ᎠᏓᎦᏘᏯᏍᏗ	Deverbal	ᎠᏓᎦᏘᏰᎭ:Baby sitting
ᎠᏓᎦᏘᏰᎭ	PresentContinous	ᎠᏓᎦᏘᏰᎭ:Baby sitting
ᎠᏓᎦᏘᏰᎰᎢ	Habitual	ᎠᏓᎦᏘᏰᎭ:Baby sitting
ᎠᏓᎦᏘᏰᎸᎢ	RemotePast	ᎠᏓᎦᏘᏰᎭ:Baby sitting
ᎠᏓᎨᏗ	Other	ᎠᏓᎨᏗ:Window pane
ᎠᏓᎨᏙᏗ	Other	ᎠᏓᎨᏙᏗ:Mirror
ᎠᏓᎨᏳᎦ	Immediate	ᎤᏓᎨᏳᎭ:Loving
ᎠᏓᎨᏳᎭ	PresentContinous	ᎤᏓᎨᏳᎭ:Loving
ᎠᏓᎨᏳᎰᎢ	Habitual	ᎤᏓᎨᏳᎭ:Loving
ᎠᏓᎨᏳᏅᎢ	RemotePast	ᎤᏓᎨᏳᎭ:Loving
ᎠᏓᎨᏳᏗ	Deverbal	ᎤᏓᎨᏳᎭ:Loving
ᎠᏓᎩᎠ	PresentContinous	ᎦᏓᎩᎠ:Taking down something solid, something flexible, or something alive
ᎠᏓᎩᏍᎪᎢ	Habitual	ᎦᏓᎩᎠ:Taking down something solid, something flexible, or something alive
ᎠᏓᎩᏍᏗ	Deverbal	ᎦᏓᎩᎠ:Taking down something solid, something flexible, or something alive
ᎠᏓᎩᏒᎢ	RemotePast	ᎦᏓᎩᎠ:Taking down something solid, something flexible, or something alive
ᎠᏓᎪᎾᏙᏗ	Other	ᎠᏓᎪᎾᏙᏗ:Prize
ᎠᏓᎯ	Other	ᎠᏓᎯ:Killer
ᎠᏓᎳᏒᎯ	Other	ᎠᏓᎳᏒᎯ:Bundle
ᎠᏓᎳᏒᎲᏍᎦ	PresentContinous	ᎠᏓᎳᏒᎲᏍᎦ:Wrapping it
ᎠᏓᎳᏒᎲᏍᎪᎢ	Habitual	ᎠᏓᎳᏒᎲᏍᎦ:Wrapping it
ᎠᏓᎳᏒᎿ	Immediate	ᎠᏓᎳᏒᎲᏍᎦ:Wrapping it
ᎠᏓᎳᏒᏅᎢ	RemotePast	ᎠᏓᎳᏒᎲᏍᎦ:Wrapping it
ᎠᏓᎳᏒᏗ	Deverbal	ᎠᏓᎳᏒᎲᏍᎦ:Wrapping it
ᎠᏓᎴᎢᏍᏗ	Deverbal	ᏓᏓᎴᎦ:Different from
ᎠᏓᎴᎦ	Immediate	ᏓᏓᎴᎦ:Different from
ᎠᏓᎴᎪᎢ	Habitual	ᏓᏓᎴᎦ:Different from
ᎠᏓᎴᏨᎢ	RemotePast	ᏓᏓᎴᎦ:Different from
ᎠᏓᎶᏍᏗ	Other	ᎠᏓᎶᏍᏗ:Constitution
ᎠᏓᎾᎦ	Immediate	ᏓᏓᎾᎩᎠ:Picking up something alive
ᎠᏓᎾᎩᎠ	PresentContinous	ᏓᏓᎾᎩᎠ:Stretching
ᎠᏓᎾᎩᏍᎪᎢ	Habitual	ᏓᏓᎾᎩᎠ:Stretching
ᎠᏓᎾᎩᏍᏗ	Deverbal	ᏓᏓᎾᎩᎠ:Stretching
ᎠᏓᎾᎩᏒᎢ	RemotePast	ᏓᏓᎾᎩᎠ:Picking up something alive
ᎠᏓᎾᎾᎦ	Immediate	ᎠᏓᎾᎾᎩᎠ:Shopping
ᎠᏓᎾᎾᎩᎠ	PresentContinous	ᎠᏓᎾᎾᎩᎠ:Shopping
ᎠᏓᎾᎾᎩᏍᎪᎢ	Habitual	ᎠᏓᎾᎾᎩᎠ:Shopping
ᎠᏓᎾᎾᎩᏍᏗ	Deverbal	ᎠᏓᎾᎾᎩᎠ:Shopping
ᎠᏓᎾᎾᎩᏒᎢ	RemotePast	ᎠᏓᎾᎾᎩᎠ:Shopping
ᎠᏓᎾᏅᎢ	Other	ᎠᏓᎾᏅᎢ:Store
ᎠᏓᎾᏫᏓ	Immediate	ᎠᏓᎾᏫᏗᎭ:Jumping forward
ᎠᏓᎾᏫᏗᎭ	PresentContinous	ᎠᏓᎾᏫᏗᎭ:Jumping forward
ᎠᏓᎾᏫᏗᏍᎪᎢ	Habitual	ᎠᏓᎾᏫᏗᎭ:Jumping forward
ᎠᏓᎾᏫᏘᏗ	Deverbal	ᎠᏓᎾᏫᏗᎭ:Jumping forward
ᎠᏓᎾᏫᏛᎲᎢ	RemotePast	ᎠᏓᎾᏫᏗᎭ:Jumping forward
ᎠᏓᏁᎭ	PresentContinous	ᎠᏓᏁᎭ:Giving something solid
ᎠᏓᏁᎰᎢ	Habitual	ᎠᏓᏁᎭ:Giving something solid
ᎠᏓᏁᎸᎢ	RemotePast	ᎠᏓᏁᎭ:Giving something solid	ᎠᏓᏁᎸᎢ:Building
ᎠᏓᏁᏌᎦ	Immediate	ᎠᏓᏁᏌᎩᎠ:Witching
ᎠᏓᏁᏌᎩᎠ	PresentContinous	ᎠᏓᏁᏌᎩᎠ:Witching
ᎠᏓᏁᏌᎩᏍᎪᎢ	Habitual	ᎠᏓᏁᏌᎩᎠ:Witching
ᎠᏓᏁᏌᎩᏍᏗ	Deverbal	ᎠᏓᏁᏌᎩᎠ:Witching
ᎠᏓᏁᏌᎬᎢ	RemotePast	ᎠᏓᏁᏌᎩᎠ:Witching
ᎠᏓᏁᏗ	Deverbal	ᎠᏓᏁᎭ:Giving something solid
ᎠᏓᏂᎸᎢᏍᏗ	Deverbal	ᏓᏓᏂᎸᎦ:Welcoming
ᎠᏓᏂᎸᎦ	Immediate	ᏓᏓᏂᎸᎦ:Welcoming
ᎠᏓᏂᎸᎪᎢ	Habitual	ᏓᏓᏂᎸᎦ:Welcoming
ᎠᏓᏂᎸᏨᎢ	RemotePast	ᏓᏓᏂᎸᎦ:Welcoming
ᎠᏓᏃᏫ	Other	ᎠᏓᏃᏫ:War
ᎠᏓᏄᎪᎳ	Immediate	ᏓᏓᏄᎪᏍᎦ:Receiving a vaccine
ᎠᏓᏄᎪᏍᎦ	PresentContinous	ᏓᏓᏄᎪᏍᎦ:Receiving a vaccine
ᎠᏓᏄᎪᏍᎪᎢ	Habitual	ᏓᏓᏄᎪᏍᎦ:Receiving a vaccine
ᎠᏓᏄᎪᏍᏗ	Deverbal	ᏓᏓᏄᎪᏍᎦ:Receiving a vaccine
ᎠᏓᏄᎪᏒᎢ	RemotePast	ᏓᏓᏄᎪᏍᎦ:Receiving a vaccine
ᎠᏓᏄᎸᎢᏍᏗ	Deverbal	ᎠᏓᏄᎸᎭ:Lazy
ᎠᏓᏄᎸᎦ	Immediate	ᎠᏓᏄᎸᎭ:Lazy
ᎠᏓᏄᎸᎭ	PresentContinous	ᎠᏓᏄᎸᎭ:Lazy
ᎠᏓᏄᎸᎰᎢ	Habitual	ᎠᏓᏄᎸᎭ:Lazy
ᎠᏓᏄᎸᏅᎢ	RemotePast	ᎠᏓᏄᎸᎭ:Lazy
ᎠᏓᏅᎠ	PresentContinous	ᎠᏓᏅᎠ:Moving (his household)
ᎠᏓᏅᎾ	Immediate	ᎠᏓᏅᎠ:Moving (his household)
ᎠᏓᏅᏍᎪᎢ	Habitual	ᎠᏓᏅᎠ:Moving (his household)
ᎠᏓᏅᏍᏗ	Deverbal	ᎠᏓᏅᎠ:Moving (his household)
ᎠᏓᏅᏏᏂᏓ	Immediate	ᎠᏓᏅᏏᏂᏙᎭ:Crawling
ᎠᏓᏅᏏᏂᏓᏍᏗ	Deverbal	ᎠᏓᏅᏏᏂᏙᎭ:Crawling
ᎠᏓᏅᏏᏂᏙᎭ	PresentContinous	ᎠᏓᏅᏏᏂᏙᎭ:Crawling
ᎠᏓᏅᏏᏂᏙᎰᎢ	Habitual	ᎠᏓᏅᏏᏂᏙᎭ:Crawling
ᎠᏓᏅᏏᏂᏙᎸᎢ	RemotePast	ᎠᏓᏅᏏᏂᏙᎭ:Crawling
ᎠᏓᏅᏒᎢ	RemotePast	ᎠᏓᏅᎠ:Moving (his household)
ᎠᏓᏅᏖᎭ	PresentContinous	ᎠᏓᏅᏖᎭ:Thinking
ᎠᏓᏅᏖᎸᎢ	RemotePast	ᎠᏓᏅᏖᎭ:Thinking
ᎠᏓᏅᏖᏍᎪᎢ	Habitual	ᎠᏓᏅᏖᎭ:Thinking
ᎠᏓᏅᏖᏏᎭ	PresentContinous	ᎠᏓᏅᏖᏏᎭ:Considering
ᎠᏓᏅᏖᏏᏍᎪᎢ	Habitual	ᎠᏓᏅᏖᏏᎭ:Considering
ᎠᏓᏅᏖᏓ	Immediate	ᎤᏓᏅᏖᏗᎭ:Worrying
ᎠᏓᏅᏖᏓᏅᎢ	RemotePast	ᎤᏓᏅᏖᏗᎭ:Worrying
ᎠᏓᏅᏖᏗ	Deverbal	ᎠᏓᏅᏖᎭ:Thinking
ᎠᏓᏅᏖᏗᎭ	PresentContinous	ᎤᏓᏅᏖᏗᎭ:Worrying
ᎠᏓᏅᏖᏗᏍᎪᎢ	Habitual	ᎤᏓᏅᏖᏗᎭ:Worrying
ᎠᏓᏅᏖᏚᏗ	Deverbal	ᎤᏓᏅᏖᏗᎭ:Worrying
ᎠᏓᏅᏛᎳ	Immediate	ᎠᏓᏅᏖᎭ:Thinking
ᎠᏓᏌᏆᎴᎦ	Immediate	ᎠᏓᏌᏆᎴᎵ:Rolling along
ᎠᏓᏌᏆᎴᎴᎸᎢ	RemotePast	ᎠᏓᏌᏆᎴᎵ:Rolling along
ᎠᏓᏌᏆᎴᎵ	PresentContinous	ᎠᏓᏌᏆᎴᎵ:Rolling along
ᎠᏓᏌᏆᎴᎵᏐᎢ	Habitual	ᎠᏓᏌᏆᎴᎵ:Rolling along
ᎠᏓᏌᏆᎴᎸᎢ	RemotePast	ᎠᏂᎠᏓᏌᏆᎴᎯᎭ:Rolling (they are)
ᎠᏓᏌᏆᎴᏍᏗ	Deverbal	ᎠᏂᎠᏓᏌᏆᎴᎯᎭ:Rolling (they are)	ᎠᏓᏌᏆᎴᎵ:Rolling along
ᎠᏓᏍᏆᎶᏍᏓᎿ	Immediate	ᎠᏓᏍᏆᎶᏍᏗᎭ:Bumping his head
ᎠᏓᏍᏆᎶᏍᏓᏅᎢ	RemotePast	ᎠᏓᏍᏆᎶᏍᏗᎭ:Bumping his head
ᎠᏓᏍᏆᎶᏍᏗᎭ	PresentContinous	ᎠᏓᏍᏆᎶᏍᏗᎭ:Bumping his head
ᎠᏓᏍᏆᎶᏍᏗᏍᎪᎢ	Habitual	ᎠᏓᏍᏆᎶᏍᏗᎭ:Bumping his head
ᎠᏓᏍᏆᎶᏗ	Deverbal	ᎠᏓᏍᏆᎶᏍᏗᎭ:Bumping his head
ᎠᏓᏍᏓᏴᏗ	Other	ᎠᏓᏍᏓᏴᏗ:Stove
ᎠᏓᏍᏕᏓᎵᏴᎠ	Immediate	ᎠᏓᏍᏕᏓᎵᏴᎡᎭ:Trading
ᎠᏓᏍᏕᏓᎵᏴᎡᎭ	PresentContinous	ᎠᏓᏍᏕᏓᎵᏴᎡᎭ:Trading
ᎠᏓᏍᏕᏓᎵᏴᎡᎰᎢ	Habitual	ᎠᏓᏍᏕᏓᎵᏴᎡᎭ:Trading
ᎠᏓᏍᏕᏓᎵᏴᎡᎸᎢ	RemotePast	ᎠᏓᏍᏕᏓᎵᏴᎡᎭ:Trading
ᎠᏓᏍᏕᏓᎵᏴᎡᏗ	Deverbal	ᎠᏓᏍᏕᏓᎵᏴᎡᎭ:Trading
ᎠᏓᏑᎧᎳ	Immediate	ᏓᏓᏑᎧᎵᎭ:Cutting his nails
ᎠᏓᏑᎧᎵᎭ	PresentContinous	ᏓᏓᏑᎧᎵᎭ:Cutting his nails
ᎠᏓᏑᎧᎵᏍᎪᎢ	Habitual	ᏓᏓᏑᎧᎵᎭ:Cutting his nails
ᎠᏓᏑᎧᎵᏗ	Deverbal	ᏓᏓᏑᎧᎵᎭ:Cutting his nails
ᎠᏓᏑᎧᎸᎲᎢ	RemotePast	ᏓᏓᏑᎧᎵᎭ:Cutting his nails
ᎠᏓᏙᎵᏍᏓ	Immediate	ᎠᏓᏙᎵᏍᏗᎭ:Praying
ᎠᏓᏙᎵᏍᏓᏅᎢ	RemotePast	ᎠᏓᏙᎵᏍᏗᎭ:Lending
ᎠᏓᏙᎵᏍᏗᎭ	PresentContinous	ᎠᏓᏙᎵᏍᏗᎭ:Lending
ᎠᏓᏙᎵᏍᏗᏍᎪᎢ	Habitual	ᎠᏓᏙᎵᏍᏗᎭ:Lending
ᎠᏓᏙᎵᏍᏙᏗ	Deverbal	ᎠᏓᏙᎵᏍᏗᎭ:Lending
ᎠᏓᏙᏚᎢᏍᏓ	Immediate	ᎠᏓᏙᏚᎢᏍᏗᎭ:Making himself attractive
ᎠᏓᏙᏚᎢᏍᏓᏅᎢ	RemotePast	ᎠᏓᏙᏚᎢᏍᏗᎭ:Making himself attractive
ᎠᏓᏙᏚᎢᏍᏗᎭ	PresentContinous	ᎠᏓᏙᏚᎢᏍᏗᎭ:Making himself attractive
ᎠᏓᏙᏚᎢᏍᏗᏍᎪᎢ	Habitual	ᎠᏓᏙᏚᎢᏍᏗᎭ:Making himself attractive
ᎠᏓᏙᏚᎢᏍᏙᏗ	Deverbal	ᎠᏓᏙᏚᎢᏍᏗᎭ:Making himself attractive
ᎠᏓᏛᎱᎦ	Immediate	ᏓᏓᏛᏂᎭ:Fist fighting
ᎠᏓᏛᏂᎭ	PresentContinous	ᏓᏓᏛᏂᎭ:Fist fighting
ᎠᏓᏛᏂᎰᎢ	Habitual	ᏓᏓᏛᏂᎭ:Fist fighting
ᎠᏓᏛᏂᎸᎢ	RemotePast	ᏓᏓᏛᏂᎭ:Fist fighting
ᎠᏓᏛᏂᏍᏗ	Deverbal	ᏓᏓᏛᏂᎭ:Fist fighting
ᎠᏓᏛᏛᎲᎦ	Immediate	ᎠᏓᏛᏛᎲᏍᎦ:Asking a question
ᎠᏓᏛᏛᎲᏍᎦ	PresentContinous	ᎠᏓᏛᏛᎲᏍᎦ:Asking a question
ᎠᏓᏛᏛᎲᏍᎪᎢ	Habitual	ᎠᏓᏛᏛᎲᏍᎦ:Asking a question
ᎠᏓᏛᏛᏅᎢ	RemotePast	ᎠᏓᏛᏛᎲᏍᎦ:Asking a question
ᎠᏓᏛᏛᏗ	Deverbal	ᎠᏓᏛᏛᎲᏍᎦ:Asking a question
ᎠᏓᏦᏍᏗ	Other	ᎠᏓᏦᏍᏗ:Belt
ᎠᏓᏬᎠ	PresentContinous	ᎠᏓᏬᎠ:Swimming
ᎠᏓᏬᎥᎢ	RemotePast	ᎠᏓᏬᎠ:Swimming
ᎠᏓᏬᎯᎵᏓ	Immediate	ᎠᏓᏬᎯᎵᏗᎠ:Climbing over
ᎠᏓᏬᎯᎵᏗᎠ	PresentContinous	ᎠᏓᏬᎯᎵᏗᎠ:Climbing over
ᎠᏓᏬᎯᎵᏗᏍᎪᎢ	Habitual	ᎠᏓᏬᎯᎵᏗᎠ:Climbing over
ᎠᏓᏬᎯᎵᏗᏍᏗ	Deverbal	ᎠᏓᏬᎯᎵᏗᎠ:Climbing over
ᎠᏓᏬᎯᎵᏛᎢ	RemotePast	ᎠᏓᏬᎯᎵᏗᎠ:Climbing over
ᎠᏓᏬᏍᎪᎢ	Habitual	ᎠᏓᏬᎠ:Swimming
ᎠᏓᏬᏍᏗ	Deverbal	ᎠᏓᏬᎠ:Swimming
ᎠᏓᏬᏣ	Immediate	ᎠᏓᏬᎠ:Swimming
ᎠᏓᏯᎯ	Other	ᎠᏓᏯᎯ:Oak
ᎠᏓᏰᏍᎩ	Other	ᎠᏓᏰᏍᎩ:Cancer
ᎠᏓᏴᏦᏗᏍᎩ	Other	ᎠᏓᏴᏦᏗᏍᎩ:Mumps
ᎠᏔ	Other	ᎠᏔ:Girl, teenage
ᎠᏔᎦ	Immediate	ᎠᏔᏍᎦ:Hanging something solid up
ᎠᏔᎳᎦᏒᎢ	Other	ᎠᏔᎳᎦᏒᎢ:Hole
ᎠᏔᎶᎥᎦ	Immediate	ᎤᏔᎶᎦ:Has his mouth open
ᎠᏔᎶᎥᏍᎪᎢ	Habitual	ᎤᏔᎶᎦ:Has his mouth open
ᎠᏔᎶᎦ	PresentContinous	ᎤᏔᎶᎦ:Has his mouth open
ᎠᏔᎶᏅᎢ	RemotePast	ᎤᏔᎶᎦ:Has his mouth open
ᎠᏔᎶᏗ	Deverbal	ᎤᏔᎶᎦ:Has his mouth open
ᎠᏔᏃᎭ	Immediate	ᎠᏔᏃᏍᎦ:Big (becoming)
ᎠᏔᏃᎯᏍᏗ	Deverbal	ᎠᏔᏃᏍᎦ:Big (becoming)
ᎠᏔᏃᏍᎦ	PresentContinous	ᎠᏔᏃᏍᎦ:Big (becoming)
ᎠᏔᏃᏍᎪᎢ	Habitual	ᎠᏔᏃᏍᎦ:Big (becoming)
ᎠᏔᏃᏒᎢ	RemotePast	ᎠᏔᏃᏍᎦ:Big (becoming)
ᎠᏔᏅᎢ	RemotePast	ᎠᏔᏍᎦ:Hanging something solid up
ᎠᏔᏍᎦ	Immediate	ᎠᏔᏍᎩᎠ:Popping	ᎠᏔᏍᎦ:Hanging something solid up
ᎠᏔᏍᎩᎠ	PresentContinous	ᎠᏔᏍᎩᎠ:Popping
ᎠᏔᏍᎩᏍᎪᎢ	Habitual	ᎠᏔᏍᎩᎠ:Bleeding
ᎠᏔᏍᎩᏍᎬᎢ	Other	ᎠᏔᏍᎩᏍᎬᎢ:Sap
ᎠᏔᏍᎩᏍᏓ	Immediate	ᎠᏔᏍᎩᏍᏗᎭ:Popping it
ᎠᏔᏍᎩᏍᏔᏅᎢ	RemotePast	ᎠᏔᏍᎩᏍᏗᎭ:Popping it
ᎠᏔᏍᎩᏍᏗ	Deverbal	ᎠᏔᏍᎩᎠ:Popping
ᎠᏔᏍᎩᏍᏗᎭ	PresentContinous	ᎠᏔᏍᎩᏍᏗᎭ:Popping it
ᎠᏔᏍᎩᏍᏗᏍᎪᎢ	Habitual	ᎠᏔᏍᎩᏍᏗᎭ:Popping it
ᎠᏔᏍᎩᏍᏙᏗ	Deverbal	ᎠᏔᏍᎩᏍᏗᎭ:Popping it
ᎠᏔᏍᎩᏒᎢ	RemotePast	ᎠᏔᏍᎩᎠ:Popping
ᎠᏔᏍᎪᎢ	Habitual	ᎠᏔᏍᎦ:Hanging something solid up
ᎠᏕᎦ	Immediate	ᎤᏕᎦ:Throwing
ᎠᏕᎪᎢ	Habitual	ᎤᏕᎦ:Throwing
ᎠᏕᎰᎭ	Immediate	ᎠᏕᎰᏍᎦ:Ashamed
ᎠᏕᎰᎯᏍᏗ	Deverbal	ᎠᏕᎰᏍᎦ:Ashamed
ᎠᏕᎰᏌᏖᏍᏔ	Immediate	ᎤᏕᎰᏌᏘ:Bashful
ᎠᏕᎰᏌᏖᏍᏗ	Deverbal	ᎤᏕᎰᏌᏘ:Bashful
ᎠᏕᎰᏌᏘ	PresentContinous	ᎤᏕᎰᏌᏘ:Bashful
ᎠᏕᎰᏌᏙᎢ	Habitual	ᎤᏕᎰᏌᏘ:Bashful
ᎠᏕᎰᏌᏛᎢ	RemotePast	ᎤᏕᎰᏌᏘ:Bashful
ᎠᏕᎰᏍᎦ	PresentContinous	ᎠᏕᎰᏍᎦ:Ashamed
ᎠᏕᎰᏍᎪᎢ	Habitual	ᎠᏕᎰᏍᎦ:Ashamed
ᎠᏕᎰᏒᎢ	RemotePast	ᎠᏕᎰᏍᎦ:Ashamed
ᎠᏕᎲᎦ	Immediate	ᎠᏕᎲᏍᎦ:Being born
ᎠᏕᎲᏍᎦ	PresentContinous	ᎠᏕᎲᏍᎦ:Being born
ᎠᏕᎲᏍᎪᎢ	Habitual	ᎠᏕᎲᏍᎦ:Being born
ᎠᏕᎳ	Immediate	ᎤᏕᎵᎦ:Going out of sight	ᎠᏕᎳ:Money
ᎠᏕᎵᎢᏍᏗ	Deverbal	ᎤᏕᎵᎦ:Going out of sight
ᎠᏕᎵᎦ	PresentContinous	ᎤᏕᎵᎦ:Going out of sight
ᎠᏕᎵᎪᎢ	Habitual	ᎤᏕᎵᎦ:Going out of sight
ᎠᏕᎵᏨᎢ	RemotePast	ᎤᏕᎵᎦ:Going out of sight
ᎠᏕᎶᎣᎭ	Immediate	ᎠᏕᎶᎣᏍᎦ:Noticing
ᎠᏕᎶᎣᎯᏍᏗ	Deverbal	ᎠᏕᎶᎣᏍᎦ:Noticing
ᎠᏕᎶᎣᏍᎦ	PresentContinous	ᎠᏕᎶᎣᏍᎦ:Noticing
ᎠᏕᎶᎣᏍᎪᎢ	Habitual	ᎠᏕᎶᎣᏍᎦ:Noticing
ᎠᏕᎶᎣᏒᎢ	RemotePast	ᎠᏕᎶᎣᏍᎦ:Noticing
ᎠᏕᎶᏆ	Immediate	ᎠᏕᎶᏆᎠ:Learning
ᎠᏕᎶᏆᎠ	PresentContinous	ᎠᏕᎶᏆᎠ:Learning
ᎠᏕᎶᏆᏍᎪᎢ	Habitual	ᎠᏕᎶᏆᎠ:Learning
ᎠᏕᎶᏆᏍᏗ	Deverbal	ᎠᏕᎶᏆᎠ:Learning
ᎠᏕᎶᏈᎥᎢ	RemotePast	ᎠᏕᎶᏆᎠ:Learning
ᎠᏕᎸᎢ	Other	ᎠᏕᎸᎢ:Dollar
ᎠᏕᏅᎢ	RemotePast	ᎠᏕᎲᏍᎦ:Being born
ᎠᏕᏒᎢ	RemotePast	ᎤᏕᎦ:Throwing
ᎠᏕᏗ	Deverbal	ᎠᏕᎲᏍᎦ:Being born
ᎠᏕᏗᏯᏍᏗ	Other	ᎠᏕᏗᏯᏍᏗ:Indian beads
ᎠᏕᏘᏯ	Immediate	ᎤᏕᏘᏱᎭ:Has a birthday
ᎠᏕᏘᏱᎭ	PresentContinous	ᎤᏕᏘᏱᎭ:Has a birthday
ᎠᏕᏘᏱᎰᎢ	Habitual	ᎤᏕᏘᏱᎭ:Has a birthday
ᎠᏕᏘᏱᏗ	Deverbal	ᎤᏕᏘᏱᎭ:Has a birthday
ᎠᏕᏘᏴᎲᎢ	RemotePast	ᎤᏕᏘᏱᎭ:Has a birthday
ᎠᏕᏯᎸᎢ	RemotePast	ᎠᏕᏲᎭ:Going in a circle	ᎠᏕᏱᎭ:Denying
ᎠᏕᏯᏍᏗ	Deverbal	ᎠᏕᏱᎭ:Denying	ᎠᏕᏲᎭ:Going in a circle
ᎠᏕᏯᏙᏓ	Immediate	ᎠᏕᏯᏙᏗᎭ:Bothering someone
ᎠᏕᏯᏙᏔᏅᎢ	RemotePast	ᎠᏕᏯᏙᏗᎭ:Bothering someone
ᎠᏕᏯᏙᏗ	Deverbal	ᎠᏕᏯᏙᏗᎭ:Bothering someone
ᎠᏕᏯᏙᏗᎭ	PresentContinous	ᎠᏕᏯᏙᏗᎭ:Bothering someone
ᎠᏕᏯᏙᏗᏍᎪᎢ	Habitual	ᎠᏕᏯᏙᏗᎭ:Bothering someone
ᎠᏕᏱᎦ	Immediate	ᎠᏕᏱᎭ:Denying
ᎠᏕᏱᎭ	PresentContinous	ᎠᏕᏱᎭ:Denying
ᎠᏕᏱᎰᎢ	Habitual	ᎠᏕᏱᎭ:Denying
ᎠᏕᏲᎦ	Immediate	ᎠᏕᏲᎭ:Going in a circle
ᎠᏕᏲᎭ	PresentContinous	ᎠᏕᏲᎭ:Going in a circle
ᎠᏕᏲᎰᎢ	Habitual	ᎠᏕᏲᎭ:Going in a circle
ᎠᏕᏲᎲᎦ	Immediate	ᏓᏕᏲᎲᏍᎦ:Teaching
ᎠᏕᏲᎲᏍᎦ	PresentContinous	ᏓᏕᏲᎲᏍᎦ:Teaching
ᎠᏕᏲᎲᏍᎪᎢ	Habitual	ᏓᏕᏲᎲᏍᎦ:Teaching
ᎠᏕᏲᏅᎢ	RemotePast	ᏓᏕᏲᎲᏍᎦ:Teaching
ᎠᏕᏲᏗ	Deverbal	ᏓᏕᏲᎲᏍᎦ:Teaching
ᎠᏖᎵᏚ	Other	ᎠᏖᎵᏚ:Plate
ᎠᏖᏍᎨᏂ	Other	ᎠᏖᏍᎨᏂ:Lower back
ᎠᏗ	Deverbal	ᎠᎲᏍᎦ:Setting it
ᎠᏗᎠ	PresentContinous	ᎠᏗᎠ:Saying it
ᎠᏗᎦ	Immediate	ᏓᏗᎦᏍᎦ:Defecating	ᎠᏗᎬᎠ:Urinating
ᎠᏗᎦᎴᏯ	Immediate	ᎠᏗᎦᎴᏯᎠ:Scattering from a pile
ᎠᏗᎦᎴᏯᎠ	PresentContinous	ᎠᏗᎦᎴᏯᎠ:Scattering from a pile
ᎠᏗᎦᎴᏯᏍᎪᎢ	Habitual	ᎠᏗᎦᎴᏯᎠ:Scattering from a pile
ᎠᏗᎦᎴᏯᏍᏗ	Deverbal	ᎠᏗᎦᎴᏯᎠ:Scattering from a pile
ᎠᏗᎦᎴᏱ	RemotePast	ᎠᏗᎦᎴᏯᎠ:Scattering from a pile
ᎠᏗᎦᏍᎦ	PresentContinous	ᏓᏗᎦᏍᎦ:Defecating
ᎠᏗᎦᏍᎪᎢ	Habitual	ᏓᏗᎦᏍᎦ:Defecating
ᎠᏗᎦᏍᏗ	Deverbal	ᏓᏗᎦᏍᎦ:Defecating
ᎠᏗᎦᏒᎢ	RemotePast	ᏓᏗᎦᏍᎦ:Defecating
ᎠᏗᎧᎸᎢ	RemotePast	ᎠᏗᎬᎠ:Urinating
ᎠᏗᎬᎠ	PresentContinous	ᎠᏗᎬᎠ:Urinating
ᎠᏗᎬᎰᎢ	Habitual	ᎠᏗᎬᎠ:Urinating
ᎠᏗᎬᏍᏗ	Deverbal	ᎠᏗᎬᎠ:Urinating
ᎠᏗᏍᎦᎳᎦ	Immediate	ᎠᏗᏍᎦᎳᏍᎦ:Hiding
ᎠᏗᏍᎦᎳᏍᎦ	PresentContinous	ᎠᏗᏍᎦᎳᏍᎦ:Hiding
ᎠᏗᏍᎦᎳᏍᎪᎢ	Habitual	ᎠᏗᏍᎦᎳᏍᎦ:Hiding
ᎠᏗᏍᎦᎳᏗ	Deverbal	ᎠᏗᏍᎦᎳᏍᎦ:Hiding
ᎠᏗᏍᎦᎸᏅᎢ	RemotePast	ᎠᏗᏍᎦᎳᏍᎦ:Hiding
ᎠᏗᏍᎪᎢ	Habitual	ᎠᏗᎠ:Saying it
ᎠᏗᏍᏗ	Deverbal	ᎠᏗᏍᏚᏍᎦ:Bowing
ᎠᏗᏍᏚᎦ	Immediate	ᎠᏗᏍᏚᏍᎦ:Bowing
ᎠᏗᏍᏚᏅᎢ	RemotePast	ᎠᏗᏍᏚᏍᎦ:Bowing
ᎠᏗᏍᏚᏍᎦ	PresentContinous	ᎠᏗᏍᏚᏍᎦ:Bowing
ᎠᏗᏍᏚᏍᎪᎢ	Habitual	ᎠᏗᏍᏚᏍᎦ:Bowing
ᎠᏗᏓ	Immediate	ᎠᏗᏗᎠ:Arising from lying
ᎠᏗᏔ	Immediate	ᎠᏗᏔᏍᎦ:Drinking
ᎠᏗᏔᎲᎢ	RemotePast	ᎠᏗᏔᏍᎦ:Drinking
ᎠᏗᏔᏍᎦ	PresentContinous	ᎠᏗᏔᏍᎦ:Drinking
ᎠᏗᏔᏍᎪᎢ	Habitual	ᎠᏗᏔᏍᎦ:Drinking
ᎠᏗᏔᏍᏗ	Deverbal	ᎠᏗᏔᏍᎦ:Drinking
ᎠᏗᏗᎠ	PresentContinous	ᎠᏗᏗᎠ:Arising from lying
ᎠᏗᏗᏍᎪᎢ	Habitual	ᎠᏗᏗᎠ:Arising from lying
ᎠᏗᏘᏗ	Deverbal	ᎠᏗᏗᎠ:Arising from lying
ᎠᏗᏙᏗ	Other	ᎠᏗᏙᏗ:Spoon
ᎠᏗᏛᎥᎢ	RemotePast	ᎠᏗᏗᎠ:Arising from lying
ᎠᏗᏩ	Immediate	ᎠᏗᏫᏍᎦ:Healing up
ᎠᏗᏫᏍᎦ	PresentContinous	ᎠᏗᏫᏍᎦ:Healing up
ᎠᏗᏫᏍᎪᎢ	Habitual	ᎠᏗᏫᏍᎦ:Healing up
ᎠᏗᏫᏍᏗ	Deverbal	ᎠᏗᏫᏍᎦ:Healing up
ᎠᏗᏫᏒᎢ	RemotePast	ᎠᏗᏫᏍᎦ:Healing up
ᎠᏘᏍᎩ	Other	ᎠᏘᏍᎩ:Right-handed
ᎠᏘᏗ	Deverbal	ᎠᏔᏍᎦ:Hanging something solid up	ᎠᏗᎠ:Saying it
ᎠᏘᏲᎭᎦ	Immediate	ᎠᏘᏲᎯᎭ:Arguing
ᎠᏘᏲᎯᎭ	PresentContinous	ᎠᏘᏲᎯᎭ:Arguing
ᎠᏘᏲᎯᎰᎢ	Habitual	ᎠᏘᏲᎯᎭ:Arguing
ᎠᏘᏲᎸᎢ	RemotePast	ᎠᏘᏲᎯᎭ:Arguing
ᎠᏘᏲᏍᏗ	Deverbal	ᎠᏘᏲᎯᎭ:Arguing
ᎠᏙᎣᎸᏍᏙᏗ	Other	ᎠᏙᎣᎸᏍᏙᏗ:Saucer
ᎠᏙᎥᏅᏓ	Immediate	ᎠᏙᎥᏅᏗᎭ:Dropping something flexible or something alive
ᎠᏙᎥᏅᏓᏅᎢ	RemotePast	ᎠᏙᎥᏅᏗᎭ:Dropping something flexible or something alive
ᎠᏙᎥᏅᏓᏍᎪᎢ	Habitual	ᎠᏙᎥᏅᏗᎭ:Dropping something flexible or something alive
ᎠᏙᎥᏅᏗᎭ	PresentContinous	ᎠᏙᎥᏅᏗᎭ:Dropping something flexible or something alive
ᎠᏙᎥᏅᏙᏗ	Deverbal	ᎠᏙᎥᏅᏗᎭ:Dropping something flexible or something alive
ᎠᏙᎨᎯᏓ	Immediate	ᏚᏙᎨᎯᏙᎭ:Stumbling
ᎠᏙᎨᎯᏓᏍᏗ	Deverbal	ᏚᏙᎨᎯᏙᎭ:Stumbling
ᎠᏙᎨᎯᏙᎭ	PresentContinous	ᏚᏙᎨᎯᏙᎭ:Stumbling
ᎠᏙᎨᎯᏙᎰᎢ	Habitual	ᏚᏙᎨᎯᏙᎭ:Stumbling
ᎠᏙᎨᎯᏙᎸᎢ	RemotePast	ᏚᏙᎨᎯᏙᎭ:Stumbling
ᎠᏙᎭ	Immediate	ᎠᏙᎯᎠ:Hollering
ᎠᏙᎯᎠ	PresentContinous	ᎠᏙᎯᎠ:Hollering
ᎠᏙᎯᏍᎪᎢ	Habitual	ᎠᏙᎯᎠ:Hollering
ᎠᏙᎯᏍᏗ	Deverbal	ᎠᏙᎯᎠ:Yelling
ᎠᏙᎯᏒᎢ	RemotePast	ᎠᏙᎯᎠ:Hollering
ᎠᏙᎳ	Immediate	ᎠᏙᎵᏍᎦ:Borrowing
ᎠᏙᎳᏅᏍᏗ	Other	ᎠᏙᎳᏅᏍᏗ:Walking stick
ᎠᏙᎴᏆ	Immediate	ᎠᏙᎴᏈᎠ:Learning
ᎠᏙᎴᏆᏍᎪᎢ	Habitual	ᎠᏙᎴᏈᎠ:Learning
ᎠᏙᎴᏆᏍᏗ	Deverbal	ᎠᏙᎴᏈᎠ:Learning
ᎠᏙᎴᏈᎠ	PresentContinous	ᎠᏙᎴᏈᎠ:Learning
ᎠᏙᎴᏋᎢ	RemotePast	ᎠᏙᎴᏈᎠ:Learning
ᎠᏙᎵᏍᎦ	PresentContinous	ᎠᏙᎵᏍᎦ:Borrowing
ᎠᏙᎵᏍᎪᎢ	Habitual	ᎠᏙᎵᏍᎦ:Borrowing
ᎠᏙᎵᏍᏗ	Deverbal	ᎠᏙᎵᏍᎦ:Borrowing
ᎠᏙᎵᏒᎢ	RemotePast	ᎠᏙᎵᏍᎦ:Borrowing
ᎠᏙᎾ	Immediate	ᏓᏙᏂᎭ:Witching
ᎠᏙᏂᎭ	PresentContinous	ᏓᏙᏂᎭ:Witching
ᎠᏙᏂᏍᎪᎢ	Habitual	ᏓᏙᏂᎭ:Witching
ᎠᏙᏂᏗ	Deverbal	ᏓᏙᏂᎭ:Witching
ᎠᏙᏅᎥᎢ	RemotePast	ᏓᏙᏂᎭ:Witching
ᎠᏙᏌᏓ	Immediate	ᎠᏙᏌᏗᎠ:Hanging something long up
ᎠᏙᏌᏗᎠ	PresentContinous	ᎠᏙᏌᏗᎠ:Hanging something long up
ᎠᏙᏌᏗᏍᎪᎢ	Habitual	ᎠᏙᏌᏗᎠ:Hanging something long up
ᎠᏙᏌᏗᏍᏗ	Deverbal	ᎠᏙᏌᏗᎠ:Hanging something long up
ᎠᏙᏌᏛᎢ	RemotePast	ᎠᏙᏌᏗᎠ:Hanging something long up
ᎠᏙᏏᎠ	Immediate	ᎠᏙᏏᏏᎭ:Taking down something long
ᎠᏙᏏᎥᎢ	RemotePast	ᎠᏙᏏᏏᎭ:Taking down something long
ᎠᏙᏏᏍᏗ	Deverbal	ᎠᏙᏏᏏᎭ:Taking down something long
ᎠᏙᏏᏏᎭ	PresentContinous	ᎠᏙᏏᏏᎭ:Taking down something long
ᎠᏙᏏᏏᏍᎪᎢ	Habitual	ᎠᏙᏏᏏᎭ:Taking down something long
ᎠᏙᏒᎥᎦ	Immediate	ᎠᏙᏒᎥᏍᎦ:Covering
ᎠᏙᏒᎥᏍᎦ	PresentContinous	ᎠᏙᏒᎥᏍᎦ:Covering
ᎠᏙᏒᎥᏍᎪᎢ	Habitual	ᎠᏙᏒᎥᏍᎦ:Covering
ᎠᏙᏒᏅᎢ	RemotePast	ᎠᏙᏒᎥᏍᎦ:Covering
ᎠᏙᏒᏗ	Deverbal	ᎠᏙᏒᎥᏍᎦ:Covering
ᎠᏙᏓᏆ	Immediate	ᎤᏙᏓᏆᎠ:Has a holiday
ᎠᏙᏓᏆᎠ	PresentContinous	ᎤᏙᏓᏆᎠ:Has a holiday
ᎠᏙᏓᏆᎥᎢ	RemotePast	ᎤᏙᏓᏆᎠ:Has a holiday
ᎠᏙᏓᏆᏍᎪᎢ	Habitual	ᎤᏙᏓᏆᎠ:Has a holiday
ᎠᏙᏓᏆᏍᏗ	Deverbal	ᎤᏙᏓᏆᎠ:Has a holiday
ᎠᏙᏪᎳᎦ	Immediate	ᎠᏙᏪᎳᎩᎠ:Burn (intr.)
ᎠᏙᏪᎳᎩᎠ	PresentContinous	ᎠᏙᏪᎳᎩᎠ:Burn (intr.)
ᎠᏙᏪᎳᎩᎥᎢ	RemotePast	ᎠᏙᏪᎳᎩᎠ:Burn (intr.)
ᎠᏙᏪᎳᎩᏍᎪᎢ	Habitual	ᎠᏙᏪᎳᎩᎠ:Burn (intr.)
ᎠᏙᏪᎳᎩᏍᏗ	Deverbal	ᎠᏙᏪᎳᎩᎠ:Burn (intr.)
ᎠᏚᎯᏂᏓ	Immediate	ᎠᏚᎯᏂᏙᎭ:Wading
ᎠᏚᎯᏂᏓᏍᏗ	Deverbal	ᎠᏚᎯᏂᏙᎭ:Wading
ᎠᏚᎯᏂᏙᎭ	PresentContinous	ᎠᏚᎯᏂᏙᎭ:Wading
ᎠᏚᎯᏂᏙᎰᎢ	Habitual	ᎠᏚᎯᏂᏙᎭ:Wading
ᎠᏚᎯᏂᏙᎸᎢ	RemotePast	ᎠᏚᎯᏂᏙᎭ:Wading
ᎠᏚᎳ	Immediate	ᎤᏚᎵᎭ:Wanting
ᎠᏚᎵᎭ	PresentContinous	ᎤᏚᎵᎭ:Wanting
ᎠᏚᎵᏍᎪᎢ	Habitual	ᎤᏚᎵᎭ:Wanting
ᎠᏚᎵᏓ	Immediate	ᎤᏚᎵᏗᎭ:Has an inclination to
ᎠᏚᎵᏔᏅᎢ	RemotePast	ᎤᏚᎵᏗᎭ:Has an inclination to
ᎠᏚᎵᏗ	Deverbal	ᎤᏚᎵᎭ:Wanting
ᎠᏚᎵᏗᎭ	PresentContinous	ᎤᏚᎵᏗᎭ:Has an inclination to
ᎠᏚᎵᏗᏍᎪᎢ	Habitual	ᎤᏚᎵᏗᎭ:Has an inclination to
ᎠᏚᎵᏙᏗ	Deverbal	ᎤᏚᎵᏗᎭ:Has an inclination to
ᎠᏚᎸᎲᎢ	RemotePast	ᎤᏚᎵᎭ:Wanting
ᎠᏚᏓᎳ	PresentContinous	ᎤᏚᏓᎳ:Responsible for or to
ᎠᏚᏓᎶᎢ	Habitual	ᎤᏚᏓᎳ:Responsible for or to
ᎠᏚᏓᎸᎥᎢ	RemotePast	ᎤᏚᏓᎳ:Responsible for or to
ᎠᏚᏓᎸᎥᎦ	Immediate	ᎤᏚᏓᎳ:Responsible for or to
ᎠᏚᏓᎸᏗ	Deverbal	ᎤᏚᏓᎳ:Responsible for or to
ᎠᏛᎥᎦ	Immediate	ᎦᏛᎥᏍᎦ:Hanging something flexible up
ᎠᏛᎥᏍᎦ	PresentContinous	ᎦᏛᎥᏍᎦ:Hanging something flexible up
ᎠᏛᎥᏍᎪᎢ	Habitual	ᎦᏛᎥᏍᎦ:Hanging something flexible up
ᎠᏛᎦᎦ	Immediate	ᎠᏛᎩᎠ:Hearing
ᎠᏛᎦᏅᎢ	RemotePast	ᎠᏛᎩᎠ:Hearing
ᎠᏛᎩᎠ	PresentContinous	ᎠᏛᎩᎠ:Hearing
ᎠᏛᎩᏍᎪᎢ	Habitual	ᎠᏛᎩᎠ:Hearing
ᎠᏛᎪᏗ	Deverbal	ᎠᏛᎩᎠ:Hearing
ᎠᏛᎭ	Immediate	ᎠᏛᏍᎦ:Growing
ᎠᏛᎯᏍᏓ	Immediate	ᎠᏛᎯᏍᏗᎭ:Rearing	ᏓᏛᎯᏍᏗᎭ:Rearing them
ᎠᏛᎯᏍᏓᏅᎢ	RemotePast	ᎠᏛᎯᏍᏗᎭ:Rearing
ᎠᏛᎯᏍᏔᏅᎢ	RemotePast	ᏓᏛᎯᏍᏗᎭ:Rearing them
ᎠᏛᎯᏍᏗ	Deverbal	ᎠᏛᏍᎦ:Growing
ᎠᏛᎯᏍᏗᎭ	PresentContinous	ᏓᏛᎯᏍᏗᎭ:Rearing them	ᎠᏛᎯᏍᏗᎭ:Rearing
ᎠᏛᎯᏍᏗᏍᎪᎢ	Habitual	ᏓᏛᎯᏍᏗᎭ:Rearing them	ᎠᏛᎯᏍᏗᎭ:Rearing
ᎠᏛᎯᏍᏙᏗ	Deverbal	ᎠᏛᎯᏍᏗᎭ:Rearing	ᏓᏛᎯᏍᏗᎭ:Rearing them
ᎠᏛᎳ	Immediate	ᎠᏛᎵᎭ:Breathing
ᎠᏛᎳᎦ	PresentContinous	ᎠᏛᎳᎦ:Spraining an ankle
ᎠᏛᎳᎦᏍᎪᎢ	Habitual	ᎠᏛᎳᎦ:Spraining an ankle
ᎠᏛᎳᎦᏍᏗ	Deverbal	ᎠᏛᎳᎦ:Spraining an ankle
ᎠᏛᎳᎦᏒᎢ	RemotePast	ᎠᏛᎳᎦ:Spraining an ankle
ᎠᏛᎵᎭ	PresentContinous	ᎠᏛᎵᎭ:Breathing
ᎠᏛᎵᏍᎪᎢ	Habitual	ᎠᏛᎵᎭ:Breathing
ᎠᏛᎵᏗ	Deverbal	ᎠᏛᎵᎭ:Breathing
ᎠᏛᎸᎥᎢ	RemotePast	ᎠᏛᎵᎭ:Breathing
ᎠᏛᏁᎦ	Immediate	ᎾᏛᏁᎭ:Doing it
ᎠᏛᏁᎭ	PresentContinous	ᎾᏛᏁᎭ:Doing it
ᎠᏛᏁᎰᎢ	Habitual	ᎾᏛᏁᎭ:Doing it
ᎠᏛᏁᎳ	Immediate	ᎠᏛᏁᎵᎭ:Acting
ᎠᏛᏁᎳᎦ	Immediate	ᎠᏛᏁᎵᎭ:Acting up
ᎠᏛᏁᎳᏒᎢ	RemotePast	ᎠᏛᏁᎵᎭ:Acting up
ᎠᏛᏁᎳᏗ	Deverbal	ᎠᏛᏁᎵᎭ:Acting up
ᎠᏛᏁᎵᎭ	PresentContinous	ᎠᏛᏁᎵᎭ:Acting
ᎠᏛᏁᎵᏍᎩ	Other	ᎠᏛᏁᎵᏍᎩ:Actor
ᎠᏛᏁᎵᏍᎪᎢ	Habitual	ᎠᏛᏁᎵᎭ:Acting up
ᎠᏛᏁᎵᏗ	Deverbal	ᎠᏛᏁᎵᎭ:Acting
ᎠᏛᏁᎸᎢ	RemotePast	ᎾᏛᏁᎭ:Doing it
ᎠᏛᏁᎸᏅᎢ	RemotePast	ᎠᏛᏁᎵᎭ:Acting
ᎠᏛᏂᏓ	Immediate	ᎠᏛᏂᏗᎠ:Coming back to live
ᎠᏛᏂᏗᎠ	PresentContinous	ᎠᏛᏂᏗᎠ:Coming back to live
ᎠᏛᏂᏗᏍᎪᎢ	Habitual	ᎠᏛᏂᏗᎠ:Coming back to live
ᎠᏛᏂᏗᏍᏗ	Deverbal	ᎠᏛᏂᏗᎠ:Coming back to live
ᎠᏛᏂᏛᎢ	RemotePast	ᎠᏛᏂᏗᎠ:Coming back to live
ᎠᏛᏅᎢ	RemotePast	ᎠᏗᎠ:Saying it	ᎦᏛᎥᏍᎦ:Hanging something flexible up	ᎦᏓᎠ:Being hanged
ᎠᏛᏅᎢᏍᏓ	Immediate	ᎠᏛᏅᎢᏍᏗᎭ:Getting ready
ᎠᏛᏅᎢᏍᏓᏅᎢ	RemotePast	ᎠᏛᏅᎢᏍᏗᎭ:Getting ready
ᎠᏛᏅᎢᏍᏗᎭ	PresentContinous	ᎠᏛᏅᎢᏍᏗᎭ:Getting ready
ᎠᏛᏅᎢᏍᏗᏍᎪᎢ	Habitual	ᎠᏛᏅᎢᏍᏗᎭ:Getting ready
ᎠᏛᏅᎢᏍᏙᏗ	Deverbal	ᎠᏛᏅᎢᏍᏗᎭ:Getting ready
ᎠᏛᏍᎦ	PresentContinous	ᎠᏛᏍᎦ:Growing
ᎠᏛᏍᎪᎢ	Habitual	ᎠᏛᏍᎦ:Growing
ᎠᏛᏍᏆᎳ	Immediate	ᎠᏛᏍᏆᎶᎠ:Cracking
ᎠᏛᏍᏆᎶᎠ	PresentContinous	ᎠᏛᏍᏆᎶᎠ:Cracking
ᎠᏛᏍᏆᎶᎥᎢ	RemotePast	ᎠᏛᏍᏆᎶᎠ:Cracking
ᎠᏛᏍᏆᎶᏍᎪᎢ	Habitual	ᎠᏛᏍᏆᎶᎠ:Cracking
ᎠᏛᏍᏆᎶᏍᏗ	Deverbal	ᎠᏛᏍᏆᎶᎠ:Cracking
ᎠᏛᏒᎢ	RemotePast	ᎠᏛᏍᎦ:Growing
ᎠᏛᏓᎾ	Other	ᎠᏛᏓᎾ:Brick
ᎠᏛᏓᏍᏓ	Immediate	ᎠᏛᏓᏍᏗᎭ:Listening
ᎠᏛᏓᏍᏓᏅᎢ	RemotePast	ᎠᏛᏓᏍᏗᎭ:Listening
ᎠᏛᏓᏍᏗᎭ	PresentContinous	ᎠᏛᏓᏍᏗᎭ:Listening
ᎠᏛᏓᏍᏗᏍᎪᎢ	Habitual	ᎠᏛᏓᏍᏗᎭ:Listening
ᎠᏛᏓᏍᏙᏗ	Deverbal	ᎠᏛᏓᏍᏗᎭ:Listening
ᎠᏛᏗ	Deverbal	ᎦᏓᎠ:Being hanged	ᎦᏛᎥᏍᎦ:Hanging something flexible up
ᎠᏛᏙᏩ	Other	ᎠᏛᏙᏩ:Moth
ᎠᏣᎪᎳ	Immediate	ᏓᏣᎪᏍᎦ:Scratching
ᎠᏣᎪᏍᎦ	PresentContinous	ᏓᏣᎪᏍᎦ:Scratching
ᎠᏣᎪᏍᎪᎢ	Habitual	ᏓᏣᎪᏍᎦ:Scratching
ᎠᏣᎪᏍᏗ	Deverbal	ᏓᏣᎪᏍᎦ:Scratching
ᎠᏣᎪᏒᎢ	RemotePast	ᏓᏣᎪᏍᎦ:Scratching
ᎠᏣᎯ	Other	ᎠᏣᎯ:Rubber, pitch, gum
ᎠᏣᏓᏥᎦ	Immediate	ᎠᎾᏓᏥᎩᎭ:Gathering together
ᎠᏣᏗ	Other	ᎠᏣᏗ:Genus: All Varieties
ᎠᏣᏯᎧᎦ	Immediate	ᎠᏣᏯᎧᎩᎠ:Kicking up a leg
ᎠᏣᏯᎧᎩᎠ	PresentContinous	ᎠᏣᏯᎧᎩᎠ:Kicking up a leg
ᎠᏣᏯᎧᎩᏍᎪᎢ	Habitual	ᎠᏣᏯᎧᎩᎠ:Kicking up a leg
ᎠᏣᏯᎧᎩᏍᏗ	Deverbal	ᎠᏣᏯᎧᎩᎠ:Kicking up a leg
ᎠᏣᏯᎧᎩᏒᎢ	RemotePast	ᎠᏣᏯᎧᎩᎠ:Kicking up a leg
ᎠᏤᎢᏍᏗ	Deverbal	ᎤᏤᎦ:Taking revenge
ᎠᏤᎤᎾᏕᏘᏱᏍᎬᎢ	Other	ᎠᏤᎤᎾᏕᏘᏱᏍᎬᎢ:New year
ᎠᏤᎦ	PresentContinous	ᎤᏤᎦ:Taking revenge
ᎠᏤᎪᎢ	Habitual	ᎤᏤᎦ:Taking revenge
ᎠᏤᎯ	Other	ᎠᏤᎯ:New
ᎠᏤᏌᏙ	Other	ᎠᏤᏌᏙ:Apron
ᎠᏤᏍᏙ	Other	ᎠᏤᏍᏙ:Mattress
ᎠᏤᏓ	Other	ᎠᏤᏓ:Genus: Alnus Serrulata
ᎠᏤᏨᎢ	RemotePast	ᎤᏤᎦ:Taking revenge
ᎠᏤᏩ	Immediate	ᎤᏤᏫᎠ:Spilling a non-liquid
ᎠᏤᏩᏍᏗ	Deverbal	ᎤᏤᏫᎠ:Spilling a non-liquid
ᎠᏤᏫᎠ	PresentContinous	ᎤᏤᏫᎠ:Spilling a non-liquid
ᎠᏤᏫᎥᎢ	RemotePast	ᎤᏤᏫᎠ:Spilling a non-liquid
ᎠᏤᏫᏍᎪᎢ	Habitual	ᎤᏤᏫᎠ:Spilling a non-liquid
ᎠᏥᎪᎥᎦ	Immediate	ᎠᏥᎪᎥᏍᎦ:Lying
ᎠᏥᎪᎥᏍᎦ	PresentContinous	ᎠᏥᎪᎥᏍᎦ:Lying
ᎠᏥᎪᎥᏍᎪᎢ	Habitual	ᎠᏥᎪᎥᏍᎦ:Lying
ᎠᏥᎪᏅᎢ	RemotePast	ᎠᏥᎪᎥᏍᎦ:Lying
ᎠᏥᎪᏗ	Deverbal	ᎠᏥᎪᎥᏍᎦ:Lying
ᎠᏥᎳ	Other	ᎠᏥᎳ:Fire
ᎠᏥᎳᎯ	Other	ᎠᏥᎳᎯ:Fireplace
ᎠᏥᎳᏙᎣᎭ	Immediate	ᎠᏥᎳᏙᎣᏍᎦ:Falling off (a corn tassel)
ᎠᏥᎳᏙᎣᎯᏍᏗ	Deverbal	ᎠᏥᎳᏙᎣᏍᎦ:Falling off (a corn tassel)
ᎠᏥᎳᏙᎣᏍᎦ	Other	ᎠᏥᎳᏙᎣᏍᎦ:Flowers, to fall off
ᎠᏥᎳᏙᎣᏍᎪᎢ	Habitual	ᎠᏥᎳᏙᎣᏍᎦ:Falling off (a corn tassel)
ᎠᏥᎳᏙᎣᏒᎢ	RemotePast	ᎠᏥᎳᏙᎣᏍᎦ:Falling off (a corn tassel)
ᎠᏥᎳᏳᎶᏗ	Other	ᎠᏥᎳᏳᎶᏗ:Fireside
ᎠᏥᎶᎠ	PresentContinous	ᎠᏥᎶᎠ:Measuring
ᎠᏥᎶᎥᎢ	RemotePast	ᎠᏥᎶᎠ:Measuring
ᎠᏥᎶᏍᎪᎢ	Habitual	ᎠᏥᎶᎠ:Measuring
ᎠᏥᎶᏍᏓᏅᎢ	RemotePast	ᏓᏥᎶᏍᏗᎭ:Drawing
ᎠᏥᎶᏍᏗ	Other	ᎠᏥᎶᏍᏗ:Yardstick	ᎠᏥᎶᎠ:Measuring
ᎠᏥᎶᏍᏗᎭ	PresentContinous	ᏓᏥᎶᏍᏗᎭ:Drawing
ᎠᏥᎶᏍᏗᏍᎪᎢ	Habitual	ᏓᏥᎶᏍᏗᎭ:Drawing
ᎠᏥᎶᏍᏗᏍᏓ	Immediate	ᏓᏥᎶᏍᏗᎭ:Drawing
ᎠᏥᎶᏍᏙᏗ	Deverbal	ᏓᏥᎶᏍᏗᎭ:Drawing
ᎠᏥᎶᏣ	Immediate	ᎠᏥᎶᎠ:Measuring
ᎠᏥᎸᏍᎩ	Other	ᎠᏥᎸᏍᎩ:Flower
ᎠᏥᏂ	Other	ᎠᏥᏂ:Cedar
ᎠᏥᏍᏓᎵᎦ	Immediate	ᎠᏥᏍᏓᎵᎦ:Catching fire
ᎠᏥᏍᏓᎵᎪᎢ	Habitual	ᎠᏥᏍᏓᎵᎦ:Catching fire
ᎠᏥᏍᏓᎵᏗ	Deverbal	ᎠᏥᏍᏓᎵᎦ:Catching fire
ᎠᏥᏍᏓᎵᏨᎢ	RemotePast	ᎠᏥᏍᏓᎵᎦ:Catching fire
ᎠᏥᏍᏙᏗ	Other	ᎠᏥᏍᏙᏗ:Container for something liquid
ᎠᏥᏲᏱᎦ	Immediate	ᎠᏥᏲᏱᎭ:Weeping
ᎠᏥᏲᏱᎭ	PresentContinous	ᎠᏥᏲᏱᎭ:Weeping
ᎠᏥᏲᏱᎰᎢ	Habitual	ᎠᏥᏲᏱᎭ:Weeping
ᎠᏥᏲᏱᎸᎢ	RemotePast	ᎠᏥᏲᏱᎭ:Weeping
ᎠᏥᏲᏱᏍᏗ	Deverbal	ᎠᏥᏲᏱᎭ:Weeping
ᎠᏦᎦ	PresentContinous	ᎤᏦᎦ:Unable to find
ᎠᏦᎨᏍᏔ	Immediate	ᎤᏦᎦ:Unable to find
ᎠᏦᎨᏍᏗ	Deverbal	ᎤᏦᎦ:Unable to find
ᎠᏦᎨᏍᏛᎢ	RemotePast	ᎤᏦᎦ:Unable to find
ᎠᏦᎪᎢ	Habitual	ᎤᏦᎦ:Unable to find
ᎠᏦᏱᎦ	Immediate	ᎠᏦᏱᎭ:Weeping
ᎠᏦᏱᎭ	PresentContinous	ᎠᏦᏱᎭ:Weeping
ᎠᏦᏱᎰᎢ	Habitual	ᎠᏦᏱᎭ:Weeping
ᎠᏦᏱᎸᎢ	RemotePast	ᎠᏦᏱᎭ:Weeping
ᎠᏦᏱᏍᏗ	Deverbal	ᎠᏦᏱᎭ:Weeping
ᎠᏦᏴᎢ	Other	ᎠᏦᏴᎢ:Fence
ᎠᏧᎦ	Immediate	ᎠᏨᎠ:Going to the bathroom
ᎠᏧᎲᎦ	Immediate	ᎠᏧᎲᏍᎦ:Fishing
ᎠᏧᎲᏍᎦ	PresentContinous	ᎠᏧᎲᏍᎦ:Fishing
ᎠᏧᎲᏍᎪᎢ	Habitual	ᎠᏧᎲᏍᎦ:Fishing
ᎠᏧᏅᎢ	RemotePast	ᎠᏧᎲᏍᎦ:Fishing
ᎠᏧᏗ	Deverbal	ᎠᏧᎲᏍᎦ:Fishing	ᎠᏧᏗ:Fish hook
ᎠᏧᏣ	Other	ᎠᏧᏣ:Boy
ᎠᏨᎠ	PresentContinous	ᎠᏨᎠ:Going to the bathroom
ᎠᏨᏈᎭ	Immediate	ᎠᏨᏈᏍᎦ:Bragging
ᎠᏨᏈᏍᎦ	PresentContinous	ᎠᏨᏈᏍᎦ:Bragging
ᎠᏨᏈᏍᎪᎢ	Habitual	ᎠᏨᏈᏍᎦ:Bragging
ᎠᏨᏈᏍᏗ	Deverbal	ᎠᏨᏈᏍᎦ:Bragging
ᎠᏨᏈᏒᎢ	RemotePast	ᎠᏨᏈᏍᎦ:Bragging
ᎠᏨᏍᎪᎢ	Habitual	ᎠᏨᎠ:Going to the bathroom
ᎠᏨᏍᏗ	Deverbal	ᎠᏨᎠ:Going to the bathroom
ᎠᏨᏍᏙᏗ	Other	ᎠᏨᏍᏙᏗ:Matches
ᎠᏨᏏᏯ	Immediate	ᎠᏨᏏᏰᎠ:Pacing back and forth
ᎠᏨᏏᏰᎠ	PresentContinous	ᎠᏨᏏᏰᎠ:Pacing back and forth
ᎠᏨᏏᏰᎥᎢ	RemotePast	ᎠᏨᏏᏰᎠ:Pacing back and forth
ᎠᏨᏏᏰᏍᎪᎢ	Habitual	ᎠᏨᏏᏰᎠ:Pacing back and forth
ᎠᏨᏏᏰᏗ	Deverbal	ᎠᏨᏏᏰᎠ:Pacing back and forth
ᎠᏨᏒᎢ	RemotePast	ᎠᏨᎠ:Going to the bathroom
ᎠᏨᏗᏯ	Other	ᎠᏨᏗᏯ:Minnow
ᎠᏨᏯᎢ	Other	ᎠᏨᏯᎢ:Rooster
ᎠᏩᏂᎦᎳ	Other	ᎠᏩᏂᎦᎳ:Weak
ᎠᏫ	Other	ᎠᏫ:Genus: Odocoileus Virginianus
ᎠᏫᎾ	Other	ᎠᏫᎾ:Boy, teenage
ᎠᏫᏒᏗᏳ	Other	ᎠᏫᏒᏗᏳ:Garden
ᎠᏬᎯᎵ	Other	ᎠᏬᎯᎵ:Genus: Haliaeetus Leucucephalus
ᎠᏬᎯᎶᎭ	Immediate	ᎦᏬᎯᎶᏍᎦ:Going over a hill
ᎠᏬᎯᎶᎯᏍᏗ	Deverbal	ᎦᏬᎯᎶᏍᎦ:Going over a hill
ᎠᏬᎯᎶᏍᎦ	PresentContinous	ᎦᏬᎯᎶᏍᎦ:Going over a hill
ᎠᏬᎯᎶᏍᎪᎢ	Habitual	ᎦᏬᎯᎶᏍᎦ:Going over a hill
ᎠᏬᎯᎶᏒᎢ	RemotePast	ᎦᏬᎯᎶᏍᎦ:Going over a hill
ᎠᏯᎠ	PresentContinous	ᎠᏯᎠ:Container (something alive) (in a)
ᎠᏯᎡᏍᏔ	Immediate	ᎠᏯᎠ:Something liquid (something alive) (in)
ᎠᏯᎡᏍᏗ	Deverbal	ᎠᏯᎠ:Container (something alive) (in a)
ᎠᏯᎡᏍᏛᎢ	RemotePast	ᎠᏯᎠ:Container (something alive) (in a)
ᎠᏯᎣᎢ	Habitual	ᎠᏯᎠ:Container (something alive) (in a)
ᎠᏯᏍᎨᏂ	Other	ᎠᏯᏍᎨᏂ:Crown of the head
ᎠᏯᏖᎾ	Other	ᎠᏯᏖᎾ:Flat
ᎠᏯᏙᎸᎢ	Other	ᎠᏯᏙᎸᎢ:Chapter
ᎠᏯᏨᏗ	Other	ᎠᏯᏨᏗ:Neck tie
ᎠᏰᎧᎵ	Other	ᎠᏰᎧᎵ:Quilt
ᎠᏰᎵ	Other	ᎠᏰᎵ:Middle (in the)
ᎠᏰᎸᎢ	Other	ᎠᏰᎸᎢ:Body
ᎠᏰᏌᏛᎢ	Other	ᎠᏰᏌᏛᎢ:Finger
ᎠᏲᎢᏍᏗ	Deverbal	ᎠᏲᎦ:Breaking
ᎠᏲᎦ	Immediate	ᎠᏲᎦ:Breaking
ᎠᏲᎪᎢ	Habitual	ᎠᏲᎦ:Breaking
ᎠᏲᎳᏅᏅ	Other	ᎠᏲᎳᏅᏅ:Carpenter
ᎠᏲᎵ	Other	ᎠᏲᎵ:Child
ᎠᏲᏍᎩ	Other	ᎠᏲᏍᎩ:Soldier
ᎠᏲᏓᏌᎲᎢ	Other	ᎠᏲᏓᏌᎲᎢ:Floor
ᎠᏲᏣ	Other	ᎠᏲᏣ:Girl, preteen
ᎠᏲᏨᎢ	RemotePast	ᎠᏲᎦ:Ruined
ᎠᏳᎢᏁᏒᎢ	RemotePast	ᎠᏳᎢᏂ:Swimming along
ᎠᏳᎢᏂ	PresentContinous	ᎠᏳᎢᏂ:Swimming along
ᎠᏳᎢᏂᏐᎢ	Habitual	ᎠᏳᎢᏂ:Swimming along
ᎠᏳᎢᏄᎦ	Immediate	ᎠᏳᎢᏂ:Swimming along
ᎠᏳᎢᏅᏍᏗ	Deverbal	ᎠᏳᎢᏂ:Swimming along
ᎠᏳᎨᏂ	Other	ᎠᏳᎨᏂ:Chin
ᎠᏳᎩᏓ	Other	ᎠᏳᎩᏓ:Hazel nut
ᎠᏳᎪᎢ	Other	ᎠᏳᎪᎢ:Jaw
ᎠᏳᏛᏗ	Deverbal	ᎾᏛᏁᎭ:Doing it
ᎠᏳᏲᎰᎭ	Immediate	ᎠᏳᏲᎰᏍᎦ:Rolling or skidding logs downhill
ᎠᏳᏲᎰᎯᏍᏗ	Deverbal	ᎠᏳᏲᎰᏍᎦ:Rolling or skidding logs downhill
ᎠᏳᏲᎰᏍᎦ	PresentContinous	ᎠᏳᏲᎰᏍᎦ:Rolling or skidding logs downhill
ᎠᏳᏲᎰᏍᎪᎢ	Habitual	ᎠᏳᏲᎰᏍᎦ:Rolling or skidding logs downhill
ᎠᏳᏲᎰᏒᎢ	RemotePast	ᎠᏳᏲᎰᏍᎦ:Rolling or skidding logs downhill
ᎠᏴ	Other	ᎠᏴ:We
ᎠᏴᏍᏉ	Other	ᎠᏴᏍᏉ:Me too
ᎠᏴᏐᎵ	Other	ᎠᏴᏐᎵ:Nose
ᎠᏴᏓᏆᎶᎠ	PresentContinous	ᎠᏴᏓᏆᎶᎠ:Thundering
ᎠᏴᏓᏆᎶᎥᎢ	RemotePast	ᎠᏴᏓᏆᎶᎠ:Thundering
ᎠᏴᏓᏆᎶᏍᎩ	Other	ᎠᏴᏓᏆᎶᏍᎩ:Thunder
ᎠᏴᏓᏆᎶᏍᎪᎢ	Habitual	ᎠᏴᏓᏆᎶᎠ:Thundering
ᎠᏴᏓᏆᎶᏍᏗ	Deverbal	ᎠᏴᏓᏆᎶᎠ:Thundering
ᎠᏴᏓᏆᎶᏣ	Immediate	ᎠᏴᏓᏆᎶᎠ:Thundering
ᎠᏴᏣᏗᏍᏗᏍᎩ	Other	ᎠᏴᏣᏗᏍᏗᏍᎩ:Refrigerator
ᎠᏴᏤᏂ	Other	ᎠᏴᏤᏂ:Neck, front of
ᎠᏴᏫᏯ	Other	ᎠᏴᏫᏯ:Native American
ᎡᎦ	PresentContinous	ᎢᎡᎦ:Going back	ᎡᎦ:Going
ᎡᎪᎢ	Habitual	ᎡᎦ:Going	ᎢᎡᎦ:Going back
ᎡᎭ	PresentContinous	ᎡᎭ:Living
ᎡᎮᏍᏔ	Immediate	ᎡᎯ:Living at	ᎡᎭ:Living
ᎡᎮᏍᏛᎢ	RemotePast	ᎡᎯ:Living at	ᎡᎭ:Living
ᎡᎯ	PresentContinous	ᎡᎯ:Living at
ᎡᎯᏍᏓᏁᎭ	PresentContinous	ᎤᏪᎯᏍᏓᏁᎭ:Aching
ᎡᎯᏍᏓᏁᎮᏍᏛᎢ	RemotePast	ᎤᏪᎯᏍᏓᏁᎭ:Aching
ᎡᎯᏍᏓᏁᎰᎢ	Habitual	ᎤᏪᎯᏍᏓᏁᎭ:Aching
ᎡᎯᏍᏓᏅᏗ	Immediate	ᎤᏪᎯᏍᏓᏁᎭ:Aching
ᎡᎯᏍᏗ	Other	ᎡᎯᏍᏗ:Pain
ᎡᎰᎢ	Habitual	ᎡᎭ:Living	ᎡᎯ:Living at
ᎡᎳ	Immediate	ᎡᎵᎠ:Thinking that	ᎡᎳ:Group (in a)
ᎡᎳᎸᎢ	RemotePast	ᎨᎶᎭ:Feeding
ᎡᎳᏍᏗ	Deverbal	ᎨᎶᎭ:Feeding
ᎡᎳᏗ	Other	ᎡᎳᏗ:Lower
ᎡᎳᏗᎠ	PresentContinous	ᎨᎳᏗᎠ:Putting something into a group
ᎡᎳᏗᏍᎪᎢ	Habitual	ᎨᎳᏗᎠ:Putting something into a group
ᎡᎳᏗᏓ	Immediate	ᎨᎳᏗᏙᎭ:Mingling
ᎡᎳᏗᏓᏍᏗ	Deverbal	ᎨᎳᏗᏙᎭ:Mingling
ᎡᎳᏗᏙᎭ	PresentContinous	ᎨᎳᏗᏙᎭ:Mingling
ᎡᎳᏗᏙᎰᎢ	Habitual	ᎨᎳᏗᏙᎭ:Mingling
ᎡᎳᏗᏙᎸᎢ	RemotePast	ᎨᎳᏗᏙᎭ:Mingling
ᎡᎳᏬᏗ	Other	ᎡᎳᏬᏗ:Yellow Hill Community
ᎡᎴᏍᏔ	Immediate	ᎡᎳ:Group (in a)
ᎡᎴᏍᏛᎢ	RemotePast	ᎡᎳ:Group (in a)
ᎡᎵᎠ	PresentContinous	ᎡᎵᎠ:Thinking that
ᎡᎵᎰᎢ	Habitual	ᎡᎵᎠ:Thinking that
ᎡᎵᏍᎩᏒᎢ	RemotePast	ᎡᎵᎠ:Thinking that
ᎡᎵᏍᏗ	Deverbal	ᎡᎵᎠ:Thinking that
ᎡᎵᏏᏁᏒᎢ	RemotePast	ᎨᎵᏏᏂ:Leading someone or something
ᎡᎵᏏᏂ	PresentContinous	ᎨᎵᏏᏂ:Leading someone or something
ᎡᎵᏏᏂᏐᎢ	Habitual	ᎨᎵᏏᏂ:Leading someone or something
ᎡᎵᏏᏅᏍᏗ	Deverbal	ᎨᎵᏏᏂ:Leading someone or something
ᎡᎶᎢ	Habitual	ᎡᎳ:Group (in a)
ᎡᎶᎦ	Immediate	ᎨᎶᎭ:Feeding
ᎡᎶᎭ	PresentContinous	ᎨᎶᎭ:Feeding
ᎡᎶᎯ	Other	ᎡᎶᎯ:World
ᎡᎶᎰᎢ	Habitual	ᎨᎶᎭ:Feeding
ᎡᎶᏘᏍᎩ	Other	ᎡᎶᏘᏍᎩ:Genus: null
ᎡᎶᏪᎯ	Other	ᎡᎶᏪᎯ:Quiet
ᎡᎷᎧ	PresentContinous	ᎤᏪᎷᎧ:Hollering
ᎡᎷᎪᎢ	Habitual	ᎤᏪᎷᎧ:Hollering
ᎡᎷᎱᏗ	Immediate	ᎤᏪᎷᎧ:Hollering
ᎡᎷᏅᎢ	RemotePast	ᎤᏪᎷᎧ:Hollering
ᎡᎸᏍᏗ	Deverbal	ᎡᎳ:Group (in a)
ᎡᎸᏗ	Other	ᎡᎸᏗ:Down
ᎡᎾ	Immediate	ᎢᎡᎦ:Going back	ᎡᎦ:Going
ᎡᏄᎦ	Immediate	ᎨᏄᎩᎠ:Pulling up weeds
ᎡᏄᎩᎠ	PresentContinous	ᎨᏄᎩᎠ:Pulling up weeds
ᎡᏄᎩᏍᎪᎢ	Habitual	ᎨᏄᎩᎠ:Pulling up weeds
ᎡᏄᎩᏍᏗ	Deverbal	ᎨᏄᎩᎠ:Pulling up weeds
ᎡᏄᎩᏒᎢ	RemotePast	ᎨᏄᎩᎠ:Pulling up weeds
ᎡᏅᎢᏍᏗ	Immediate	ᎤᏪᏅᎦ:Rich (becoming)
ᎡᏅᎦ	PresentContinous	ᎤᏪᏅᎦ:Rich (becoming)
ᎡᏅᎪᎢ	Habitual	ᎤᏪᏅᎦ:Rich (becoming)
ᎡᏅᏍᏗ	Deverbal	ᎢᎡᎦ:Going back	ᎡᎦ:Going
ᎡᏅᏨᎢ	RemotePast	ᎤᏪᏅᎦ:Rich (becoming)
ᎡᏆ	Other	ᎡᏆ:Large
ᎡᏉᏂ	Other	ᎡᏉᏂ:River
ᎡᏒᎢ	RemotePast	ᎡᎦ:Going	ᎢᎡᎦ:Going back
ᎡᏓ	Immediate	ᎡᏙᎭ:Walking about	ᎨᎳᏗᎠ:Putting something into a group
ᎡᏓᏍᏗ	Deverbal	ᎡᏙᎭ:Walking about	ᎡᏓᏍᏗ:Walkway
ᎡᏗᏍᏗ	Deverbal	ᎨᎳᏗᎠ:Putting something into a group
ᎡᏙᎭ	PresentContinous	ᎡᏙᎭ:Walking about
ᎡᏙᎰᎢ	Habitual	ᎡᏙᎭ:Walking about
ᎡᏙᎵᏓ	Immediate	ᎡᏙᎵᏙᎭ:Loafing
ᎡᏙᎵᏓᏍᏗ	Deverbal	ᎡᏙᎵᏙᎭ:Loafing
ᎡᏙᎵᏙᎭ	PresentContinous	ᎡᏙᎵᏙᎭ:Loafing
ᎡᏙᎵᏙᎰᎢ	Habitual	ᎡᏙᎵᏙᎭ:Loafing
ᎡᏙᎵᏙᎸᎢ	RemotePast	ᎡᏙᎵᏙᎭ:Loafing
ᎡᏙᎸᎢ	RemotePast	ᎡᏙᎭ:Walking about
ᎡᏛᎢ	RemotePast	ᎨᎳᏗᎠ:Putting something into a group
ᎡᏪᎯᏍᏓᏅᏗ	Deverbal	ᎤᏪᎯᏍᏓᏁᎭ:Aching
ᎡᏪᎷᎱᏗ	Deverbal	ᎤᏪᎷᎧ:Hollering
ᎡᏪᏅᎢᏍᏗ	Deverbal	ᎤᏪᏅᎦ:Rich (becoming)
ᎡᏯ	Immediate	ᎨᏯ:Flowing
ᎡᏰᎵᏏᏄᎦ	Immediate	ᎨᎵᏏᏂ:Leading someone or something
ᎡᏲᎢ	Habitual	ᎨᏯ:Flowing
ᎡᏲᎲᎦ	Immediate	ᏕᎨᏲᎲᏍᎦ:Teaching (ehyohv)
ᎡᏲᎲᏍᎦ	PresentContinous	ᏕᎨᏲᎲᏍᎦ:Teaching (ehyohv)
ᎡᏲᎲᏍᎪᎢ	Habitual	ᏕᎨᏲᎲᏍᎦ:Teaching (ehyohv)
ᎡᏲᏅᎢ	RemotePast	ᏕᎨᏲᎲᏍᎦ:Teaching (ehyohv)
ᎡᏲᏗ	Deverbal	ᏕᎨᏲᎲᏍᎦ:Teaching (ehyohv)
ᎡᏴᎢ	RemotePast	ᎨᏯ:Flowing
ᎡᏴᎯᏍᏓ	Immediate	ᎨᏴᎯᏍᏗᎭ:Causing it to flow
ᎡᏴᎯᏍᏓᏅᎢ	RemotePast	ᎨᏴᎯᏍᏗᎭ:Causing it to flow
ᎡᏴᎯᏍᏗᎭ	PresentContinous	ᎨᏴᎯᏍᏗᎭ:Causing it to flow
ᎡᏴᎯᏍᏗᏍᎪᎢ	Habitual	ᎨᏴᎯᏍᏗᎭ:Causing it to flow
ᎡᏴᎯᏍᏙᏗ	Deverbal	ᎨᏴᎯᏍᏗᎭ:Causing it to flow
ᎡᏴᏗ	Deverbal	ᎨᏯ:Flowing
ᎢᎦ	Other	ᎢᎦ:Day
ᎢᎦᎾᏍᏗ	Other	ᎢᎦᎾᏍᏗ:Solomon's seal
ᎢᎦᏗ	Other	ᎢᎦᏗ:Height
ᎢᎪᎯᏛ	Other	ᎢᎪᎯᏛ:Until
ᎢᎪᏪᏍᏗ	Other	ᎢᎪᏪᏍᏗ:Pronunciation
ᎢᎬᏁᎢᏍᏗ	Other	ᎢᎬᏁᎢᏍᏗ:Word
ᎢᎯᏍᏉ	Other	ᎢᎯᏍᏉ:You too
ᎢᎾ	Other	ᎢᎾ:Far
ᎢᎾᎨᎢ	Other	ᎢᎾᎨᎢ:Wild
ᎢᎾᏓ	Other	ᎢᎾᏓ:Snake
ᎢᏂᎦᏗ	Other	ᎢᏂᎦᏗ:Tall
ᎢᏃᎵ	Other	ᎢᏃᎵ:Black Fox (Surname)
ᎢᏅᎯᏳ	Other	ᎢᏅᎯᏳ:Far far away
ᎢᏣ	Other	ᎢᏣ:Towards
ᎢᏧᎳ	Other	ᎢᏧᎳ:Both
ᎢᏯ	Other	ᎢᏯ:Pumpkin
ᎢᏯᎳᏏᏅᎯ	Other	ᎢᏯᎳᏏᏅᎯ:One foot (12 inches)
ᎢᏯᏅᏓ	Other	ᎢᏯᏅᏓ:Several months ago
ᎢᏯᏏᏔᏛᎯ	Other	ᎢᏯᏏᏔᏛᎯ:Inch
ᎢᏯᏔᏬᏍᏓᏅᎯ	Other	ᎢᏯᏔᏬᏍᏓᏅᎯ:Minute(s)
ᎢᏳᏉ	Other	ᎢᏳᏉ:Some other time
ᎢᏳᏍᏗ	Other	ᎢᏳᏍᏗ:Like
ᎢᏳᏍᏗᏉ	Other	ᎢᏳᏍᏗᏉ:Any
ᎢᏳᏓᎴᎦ	Other	ᎢᏳᏓᎴᎦ:Several
ᎢᏳᏥᎶᏓ	Other	ᎢᏳᏥᎶᏓ:Yard
ᎢᏳᏩᏂᎸᎯ	Other	ᎢᏳᏩᏂᎸᎯ:Time
ᎢᏳᏪᏅᏍᏗ	Other	ᎢᏳᏪᏅᏍᏗ:Hour
Ꭳ	Immediate	ᎤᏬᎳ:Sitting
ᎣᎠ	PresentContinous	ᏕᎪᎠ:Naming him
ᎣᎥᎢ	RemotePast	ᏕᎪᎠ:Naming him
ᎣᎦ	Immediate	ᎪᎩᏍᎦ:Smoking
ᎣᎦᏅ	Other	ᎣᎦᏅ:Ground hog
ᎣᎩᎩᏒᎢ	RemotePast	ᎪᎩᏍᎦ:Smoking
ᎣᎩᏍᎦ	PresentContinous	ᎪᎩᏍᎦ:Smoking
ᎣᎩᏍᎪᎢ	Habitual	ᎪᎩᏍᎦ:Smoking
ᎣᎩᏍᏗ	Deverbal	ᎪᎩᏍᎦ:Smoking
ᎣᎯᏳᎭ	PresentContinous	ᎤᏬᎯᏳᎭ:Believing in
ᎣᎯᏳᎰᎢ	Habitual	ᎤᏬᎯᏳᎭ:Believing in
ᎣᎯᏳᎲᎦ	Immediate	ᎪᎯᏳᎲᏍᎦ:Believing him
ᎣᎯᏳᎲᏍᎦ	PresentContinous	ᎪᎯᏳᎲᏍᎦ:Believing him
ᎣᎯᏳᎲᏍᎪᎢ	Habitual	ᎪᎯᏳᎲᏍᎦ:Believing him
ᎣᎯᏳᏅᎢ	RemotePast	ᎪᎯᏳᎲᏍᎦ:Believing him	ᎤᏬᎯᏳᎭ:Believing in
ᎣᎯᏳᏗ	Immediate	ᎤᏬᎯᏳᎭ:Believing in	ᎪᎯᏳᎲᏍᎦ:Believing him
ᎣᎰᎭ	Immediate	ᎪᎰᏍᎦ:Falling (solid)
ᎣᎰᎯᏍᏗ	Deverbal	ᎪᎰᏍᎦ:Falling (solid)
ᎣᎰᎾᏓ	Immediate	ᎪᎰᎾᏗᎭ:Knocking off something solid
ᎣᎰᎾᏔᏅᎢ	RemotePast	ᎪᎰᎾᏗᎭ:Knocking off something solid
ᎣᎰᎾᏗᎭ	PresentContinous	ᎪᎰᎾᏗᎭ:Knocking off something solid
ᎣᎰᎾᏗᏍᎪᎢ	Habitual	ᎪᎰᎾᏗᎭ:Knocking off something solid
ᎣᎰᎾᏙᏗ	Deverbal	ᎪᎰᎾᏗᎭ:Knocking off something solid
ᎣᎰᏍᎦ	PresentContinous	ᎪᎰᏍᎦ:Falling (solid)
ᎣᎰᏍᎪᎢ	Habitual	ᎪᎰᏍᎦ:Falling (solid)
ᎣᎰᏎᎭ	PresentContinous	ᎤᏬᎰᏎᎭ:Dropping accidentally something solid
ᎣᎰᏎᎰᎢ	Habitual	ᎤᏬᎰᏎᎭ:Dropping accidentally something solid
ᎣᎰᏎᎸᎢ	RemotePast	ᎤᏬᎰᏎᎭ:Dropping accidentally something solid
ᎣᎰᏎᏗ	Immediate	ᎤᏬᎰᏎᎭ:Dropping accidentally something solid
ᎣᎰᏒᎢ	RemotePast	ᎪᎰᏍᎦ:Falling (solid)
ᎣᎲᎾᏓ	Immediate	ᎪᎲᎾᏗᎭ:Knocking off something liquid
ᎣᎲᎾᏔᏅᎢ	RemotePast	ᎪᎲᎾᏗᎭ:Knocking off something liquid
ᎣᎲᎾᏗᎭ	PresentContinous	ᎪᎲᎾᏗᎭ:Knocking off something liquid
ᎣᎲᎾᏗᏍᎪᎢ	Habitual	ᎪᎲᎾᏗᎭ:Knocking off something liquid
ᎣᎲᎾᏙᏗ	Deverbal	ᎪᎲᎾᏗᎭ:Knocking off something liquid
ᎣᎳ	Other	ᎣᎳ:Soap	ᎤᏬᎳ:Sitting
ᎣᎴᏍᏛᎢ	RemotePast	ᎤᏬᎳ:Sitting
ᎣᎵᎦ	Other	ᎣᎵᎦ:Red Horse	ᎪᎵᎧ:Understanding it
ᎣᎵᎧ	PresentContinous	ᎪᎵᎧ:Understanding it
ᎣᎵᎪᎢ	Habitual	ᎪᎵᎧ:Acquainted with
ᎣᎵᏍᏗ	Deverbal	ᎪᎵᎧ:Acquainted with
ᎣᎵᏨᎢ	RemotePast	ᎪᎵᎧ:Acquainted with
ᎣᎶᎢ	Habitual	ᎤᏬᎳ:Sitting
ᎣᏁᎦᏂᏱᏍᎩ	Other	ᎣᏁᎦᏂᏱᏍᎩ:Catcher, hind (baseball)
ᎣᏂ	Other	ᎣᏂ:Last
ᎣᏂᏗᏣ	Other	ᎣᏂᏗᏣ:Behind
ᎣᏍᎨᏫ	Other	ᎣᏍᎨᏫ:Genus: Brassica Aleracea
ᎣᏍᎪᎢ	Habitual	ᏕᎪᎠ:Naming him
ᎣᏍᏓᎵᏅᏥ	Other	ᏗᎾᎵᏅᏥ:Brothers
ᎣᏍᏗ	Other	ᎣᏍᏗ:Good	ᏕᎪᎠ:Naming him
ᎣᏏ	Other	ᎣᏏ:Good
ᎣᏏᏳ	Other	ᎣᏏᏳ:Very good
ᎣᏒᎾ	Immediate	ᎪᏒᏍᎦ:Forming
ᎣᏒᏅᎢ	RemotePast	ᎪᏒᏍᎦ:Forming
ᎣᏒᏍᎦ	PresentContinous	ᎪᏒᏍᎦ:Forming
ᎣᏒᏍᎪᎢ	Habitual	ᎪᏒᏍᎦ:Forming
ᎣᏒᏗ	Deverbal	ᎪᏒᏍᎦ:Forming
ᎣᏓᎵ	Other	ᎣᏓᎵ:Mountain
ᎣᏓᎵᎦᎵ	Other	ᎣᏓᎵᎦᎵ:Ginseng
ᎣᏗ	Deverbal	ᎤᏬᎳ:Sitting
ᎣᏘᎭ	Immediate	ᎪᏘᏍᎦ:Swelling
ᎣᏘᏍᎦ	PresentContinous	ᎪᏘᏍᎦ:Swelling
ᎣᏘᏍᎪᎢ	Habitual	ᎪᏘᏍᎦ:Swelling
ᎣᏘᏏ	Deverbal	ᎪᏘᏍᎦ:Swelling
ᎣᏘᏒᎢ	RemotePast	ᎪᏘᏍᎦ:Swelling
ᎣᏚᎭ	PresentContinous	ᎤᏬᏚᎭ:Attractive
ᎣᏚᎮᏍᏗ	Immediate	ᎤᏬᏚᎭ:Attractive
ᎣᏚᎮᏍᏛᎢ	RemotePast	ᎤᏬᏚᎭ:Attractive
ᎣᏚᎰᎢ	Habitual	ᎤᏬᏚᎭ:Attractive
ᎣᏛᎳᏘᎢ	Other	ᎣᏛᎳᏘᎢ:Genus: Thamnophis Sp
ᎣᏛᏠᎣᏗ	Other	ᎣᏛᏠᎣᏗ:Side of a mountain (on the)
ᎣᏪᎳᎦ	Immediate	ᎪᏪᎵᎠ:Writing	ᎪᏪᎳᎩᎠ:Erasing
ᎣᏪᎳᎩᎠ	PresentContinous	ᎪᏪᎳᎩᎠ:Erasing
ᎣᏪᎳᎩᏍᎪᎢ	Habitual	ᎪᏪᎳᎩᎠ:Erasing
ᎣᏪᎳᎩᏍᏗ	Deverbal	ᎪᏪᎳᎩᎠ:Erasing
ᎣᏪᎳᎩᏒᎢ	RemotePast	ᎪᏪᎳᎩᎠ:Erasing
ᎣᏪᎳᏅᎢ	RemotePast	ᎪᏪᎵᎠ:Writing
ᎣᏪᎳᏍᎪᎢ	Habitual	ᎪᏪᎵᎠ:Writing
ᎣᏪᎵᎠ	PresentContinous	ᎪᏪᎵᎠ:Writing
ᎣᏪᎵᏍᎪᎢ	Habitual	ᎪᏪᎵᎠ:Writing
ᎣᏪᎶᏗ	Deverbal	ᎪᏪᎵᎠ:Writing
ᎣᏬᎯᏳᏗ	Deverbal	ᎤᏬᎯᏳᎭ:Believing in
ᎣᏬᎰᏎᏗ	Deverbal	ᎤᏬᎰᏎᎭ:Dropping accidentally something solid
ᎣᏬᏚᎮᏍᏗ	Deverbal	ᎤᏬᏚᎭ:Attractive
ᎣᏲᎢᏌ	Immediate	ᏕᎪᎠ:Naming him
ᎣᏲᎵᏍᏔ	Immediate	ᎪᎵᎧ:Acquainted with
ᎤᎢᎶᎠ	PresentContinous	ᎫᎢᎶᎠ:Washing something long
ᎤᎢᎶᎥᎢ	RemotePast	ᎫᎢᎶᎠ:Washing something long
ᎤᎢᎶᏍᎪᎢ	Habitual	ᎫᎢᎶᎠ:Washing something long
ᎤᎢᎶᏍᏗ	Deverbal	ᎫᎢᎶᎠ:Washing something long
ᎤᎢᎶᏣ	Immediate	ᎫᎢᎶᎠ:Washing something long
ᎤᎦ	Immediate	ᎫᎩᎠ:Taking something solid from something liquid
ᎤᎦᎹ	Other	ᎤᎦᎹ:Soup
ᎤᎦᎾᏍᏓ	Other	ᎤᎦᎾᏍᏓ:Sweet
ᎤᎦᏍᏙᎯ	Other	ᎤᎦᏍᏙᎯ:Pillow
ᎤᎦᏎᏂ	Other	ᎤᎦᏎᏂ:Anus
ᎤᎦᏑᎯ	Other	ᎤᎦᏑᎯ:Genus: Coluber Constrictor
ᎤᎦᏔ	Other	ᎤᎦᏔ:Seed
ᎤᎦᏔᏄᎶᏓ	Other	ᎤᎦᏔᏄᎶᏓ:Eyelid
ᎤᎦᏘᏳᏩᏅᎢ	Other	ᎤᎦᏘᏳᏩᏅᎢ:Eyebrow
ᎤᎦᏥᏅᎪᏥᏛ	Other	ᎤᎦᏥᏅᎪᏥᏛ:Rusty
ᎤᎧᎭᏗ	Other	ᎤᎧᎭᏗ:Fog
ᎤᎧᏖᎾ	Other	ᎤᎧᏖᎾ:Snake, with deer horns (mythical)
ᎤᎧᏛᎢ	Other	ᎤᎧᏛᎢ:Face
ᎤᎨᏬᏓ	Other	ᎤᎨᏬᏓ:Bald
ᎤᎨᏬᏗ	Other	ᎤᎨᏬᏗ:Bald
ᎤᎩᎠ	PresentContinous	ᎫᎩᎠ:Taking something solid from something liquid
ᎤᎩᎯᏍᏗᏳ	Other	ᎤᎩᎯᏍᏗᏳ:Throat
ᎤᎩᏍᎪᎢ	Habitual	ᎫᎩᎠ:Taking something solid from something liquid
ᎤᎩᏍᏗ	Deverbal	ᎫᎩᎠ:Taking something solid from something liquid
ᎤᎩᏒᎢ	RemotePast	ᎫᎩᎠ:Taking something solid from something liquid
ᎤᎩᏓᎵ	Other	ᎤᎩᏓᎵ:Feather
ᎤᎪᎸ	Other	ᎤᎪᎸ:Sun perch
ᎤᎪᏅ	Other	ᎤᎪᏅ:Testicle
ᎤᎫᎫ	Other	ᎤᎫᎫ:Hoot howl
ᎤᎫᎫᏍᏙ	Other	ᎤᎫᎫᏍᏙ:Lousewort
ᎤᎫᏇᎯ	Other	ᎤᎫᏇᎯ:Quail
ᎤᎬᎲᎣᎵᏗ	Other	ᎤᎬᎲᎣᎵᏗ:Tuberculosis
ᎤᎬᏫᏳᎯ	Other	ᎤᎬᏫᏳᎯ:Ruler
ᎤᎭ	PresentContinous	ᎫᎭ:Something liquid (something solid) (in)
ᎤᎭᎨᏓ	Other	ᎤᎭᎨᏓ:Thick
ᎤᎮᏍᏔ	Immediate	ᎫᎭ:Something liquid (something solid) (in)
ᎤᎮᏍᏗ	Deverbal	ᎫᎭ:Something liquid (something solid) (in)
ᎤᎮᏍᏛᎢ	RemotePast	ᎫᎭ:Something liquid (something solid) (in)
ᎤᎯᎶᎠ	PresentContinous	ᎫᎯᎶᎠ:Washing something solid
ᎤᎯᎶᎥᎢ	RemotePast	ᎫᎯᎶᎠ:Washing something solid
ᎤᎯᎶᏍᎪᎢ	Habitual	ᎫᎯᎶᎠ:Washing something solid
ᎤᎯᎶᏍᏗ	Deverbal	ᎫᎯᎶᎠ:Washing something solid
ᎤᎯᎶᏣ	Immediate	ᎫᎯᎶᎠ:Washing something solid
ᎤᎰᎢ	Habitual	ᎫᎭ:Something liquid (something solid) (in)
ᎤᎳᎾ	Other	ᎤᎳᎾ:Mother's brother's wife
ᎤᎳᏏᏕᏂ	Other	ᎤᎳᏏᏕᏂ:Foot
ᎤᎳᏑᎶ	Other	ᎤᎳᏑᎶ:Shoe
ᎤᎴᏍᏓᎸᎢ	Other	ᎤᎴᏍᏓᎸᎢ:Vagina
ᎤᎴᏐᏓ	Other	ᎤᎴᏐᏓ:Skinny
ᎤᎵᏂᎩᏓ	Other	ᎤᎵᏂᎩᏓ:Strong
ᎤᎵᏍᏆᏗᏍᎬᎢ	Other	ᎤᎵᏍᏆᏗᏍᎬᎢ:Earache
ᎤᎵᏍᏇᏔᏬᎯ	Other	ᎤᎵᏍᏇᏔᏬᎯ:Hat
ᎤᎵᏍᏓ	Other	ᎤᎵᏍᏓ:Quick
ᎤᎵᏍᏓᎸᎢ	Other	ᎤᎵᏍᏓᎸᎢ:Sore
ᎤᎵᏍᏓᏴᏗ	Other	ᎤᎵᏍᏓᏴᏗ:Food
ᎤᎵᏍᏗ	Other	ᎤᎵᏍᏗ:Weak
ᎤᎵᏏ	Other	ᎤᎵᏏ:Grandmother
ᎤᎵᏏᏂᏕᎾ	Other	ᎤᎵᏏᏂᏕᎾ:Evening
ᎤᎵᏗᏨ	Other	ᎤᎵᏗᏨ:Next to
ᎤᎵᏬᏨᎯ	Other	ᎤᎵᏬᏨᎯ:Dead
ᎤᎵᏰᏑᏍᏓᏬ	Other	ᎤᎵᏰᏑᏍᏓᏬ:Ring
ᎤᎵᏲᎯ	Other	ᎤᎵᏲᎯ:Sock
ᎤᎶᎩ	Other	ᎤᎶᎩ:Father's sister
ᎤᎶᎩᎸ	Other	ᎤᎶᎩᎸ:Cloud
ᎤᎶᎪᎰᏍᏗ	Other	ᎤᎶᎪᎰᏍᏗ:Fall (season)
ᎤᎶᏐᏅ	Other	ᎤᎶᏐᏅ:Afterwards
ᎤᎶᏥᎬ	Other	ᎤᎶᏥᎬ:Oarlock
ᎤᎷᎯᏗ	Other	ᎤᎷᎯᏗ:Receiving place
ᎤᎸᎢ	Other	ᎤᎸᎢ:Sister's sister
ᎤᎸᏅᏘᏍᎩ	Other	ᎤᎸᏅᏘᏍᎩ:Lunatic
ᎤᎸᏌᏘ	Other	ᎤᎸᏌᏘ:Transparent
ᎤᎸᏗ	Other	ᎤᎸᏗ:Poison oak
ᎤᎾᎶᎢᏓ	Other	ᎤᎾᎶᎢᏓ:Plaid
ᎤᎾᏄᏍᏗ	Other	ᎤᎾᏄᏍᏗ:Hoar frost
ᎤᎾᏅᏣᏘ	Other	ᎤᏅᏣᏘ:Speckled trout
ᎤᎾᏆᎸ	Other	ᎤᎾᏆᎸ:Maryville, TN
ᎤᎾᏍᏕᏥ	Other	ᎤᎾᏍᏕᏥ:Root
ᎤᎾᏕᏘᏱᏍᎬᎢ	Other	ᎤᎾᏕᏘᏱᏍᎬᎢ:Christmas
ᎤᎾᏤᏥᏗ	Other	ᎤᎾᏤᏥᏗ:Candy roaster squash
ᎤᎾᏥ	Other	ᎤᎾᏥ:Parent-in-law
ᎤᎾᏩ	Other	ᎤᎾᏩ:Dish
ᎤᏁᎦ	Other	ᎤᏁᎦ:White
ᎤᏁᎦᎸᎢ	Other	ᎤᏁᎦᎸᎢ:Skin
ᎤᏁᎦᎸᏅ	Other	ᎤᏁᎦᎸᏅ:Peel
ᎤᏁᎦᏓ	Other	ᎤᏁᎦᏓ:Yellow shafted flicker
ᎤᏁᎳᏅᎯ	Other	ᎤᏁᎳᏅᎯ:God
ᎤᏁᎸᏒ	Other	ᎤᏁᎸᏒ:Scar
ᎤᏁᏍᎩᎸᎢ	Other	ᎤᏁᏍᎩᎸᎢ:Nest
ᎤᏁᏍᏓᎵ	Other	ᎤᏁᏍᏓᎵ:Ice
ᎤᏁᏘ	Other	ᎤᏁᏘ:Freckles
ᎤᏂᎵ	Other	ᎤᏂᎵ:Brother's older brother
ᎤᏂᎶᏇ	Other	ᎤᏂᎶᏇ:Slicky mushroom
ᎤᏂᏁᎫᎯᏍᏗ	Other	ᎤᏂᏁᎫᎯᏍᏗ:Tomato(es)
ᎤᏂᏆ	Other	ᎤᏂᏆ:Black gum
ᎤᏂᏍᏆᎵ	Other	ᎤᏂᏍᏆᎵ:Heartleaf
ᎤᏂᏍᏇᏚᎦ	Other	ᎤᏂᏍᏇᏚᎦ:May apple
ᎤᏂᏍᏕᎴᏍᏗ	Other	ᎤᏂᏍᏕᎴᏍᏗ:Wild comfrey
ᎤᏂᏏ	Other	ᎤᏂᏏ:Grandson
ᎤᏂᏒᏙᏂ	Other	ᎤᏂᏒᏙᏂ:Hollow mushrooms
ᎤᏂᏖᎸᎳᏗ	Other	ᎤᏂᏖᎸᎳᏗ:Wild grapes
ᎤᏂᏣᏘ	Other	ᎤᏂᏣᏘ:Mass of people
ᎤᏂᏣᏛ	Other	ᎤᏂᏣᏛ:Many
ᎤᏂᏥᎸᎢ	Other	ᎤᏂᏥᎸᎢ:Pepper on a vine
ᎤᏂᏥᏯ	Other	ᎤᏂᏥᏯ:Red worms
ᎤᏂᏨᎾᏓᎵ	Other	ᎤᏂᏨᎾᏓᎵ:Peas
ᎤᏃᎧ	Other	ᎤᏃᎧ:Genus: Micropterus Sp
ᎤᏃᎴᎯ	Other	ᎤᏃᎴᎯ:Wind
ᎤᏃᏕᎾ	Other	ᎤᏃᏕᎾ:Sheep
ᎤᏃᏴ	Other	ᎤᏃᏴ:Genus: Bombycilla Cedroro
ᎤᏄᏥ	Other	ᎤᏄᏥ:Son-in-law
ᎤᏅᎩᏅ	Other	ᎤᏅᎩᏅ:Genus: Castanea Sp
ᎤᏅᎪᎳᏛ	Other	ᎤᏅᎪᎳᏛ:Rainbow
ᎤᏅᏌᏗ	Other	ᎤᏅᏌᏗ:Rattle wrapped around the leg
ᎤᏅᏏᏴᎢ	Other	ᎤᏅᏏᏴᎢ:Corner
ᎤᏅᏓᏒᎢ	Other	ᎤᏅᏓᏒᎢ:Mountain
ᎤᏅᏔᏆᎵ	Other	ᎤᏅᏔᏆᎵ:Small pox
ᎤᏅᏗ	Other	ᎤᏅᏗ:Milk
ᎤᏅᏚᎯᏍᏓ	Other	ᎤᏅᏚᎯᏍᏓ:Ground cherry
ᎤᏅᏣᏗ	Other	ᎤᏅᏣᏗ:Speckled
ᎤᏅᏣᏘ	Other	ᎤᏅᏣᏘ:Speckled trout
ᎤᏅᏥ	Other	ᎤᏅᏥ:Snow on the ground
ᎤᏅᏥᏓ	Other	ᎤᏅᏥᏓ:Brains
ᎤᏅᏪᏓ	Other	ᎤᏅᏪᏓ:Bowl
ᎤᏆᎶᎦ	Other	ᎤᏆᎶᎦ:Leaf
ᎤᏆᏍᏓᎷᏱᏓ	Other	ᎤᏆᏍᏓᎷᏱᏓ:Ragweed
ᎤᏇᏓᎸᎢ	Other	ᎤᏇᏓᎸᎢ:Flesh
ᎤᏌᎥᎦ	Immediate	ᎫᏌᎥᏍᎦ:Covering
ᎤᏌᎥᏍᎦ	PresentContinous	ᎫᏌᎥᏍᎦ:Covering
ᎤᏌᎥᏍᎪᎢ	Habitual	ᎫᏌᎥᏍᎦ:Covering it
ᎤᏌᎦ	Immediate	ᎫᏌᎩᎠ:Uncovering it
ᎤᏌᎩᎠ	PresentContinous	ᎫᏌᎩᎠ:Uncovering
ᎤᏌᎩᏍᎪᎢ	Habitual	ᎫᏌᎩᎠ:Uncovering it
ᎤᏌᎩᏍᏗ	Deverbal	ᎫᏌᎩᎠ:Uncovering it
ᎤᏌᎩᏒᎢ	RemotePast	ᎫᏌᎩᎠ:Uncovering it
ᎤᏌᎴᏂ	Other	ᎤᏌᎴᏂ:Coat
ᎤᏌᏅᎢ	RemotePast	ᎫᏌᎥᏍᎦ:Covering
ᎤᏌᏗ	Deverbal	ᎫᏌᎥᏍᎦ:Covering
ᎤᏍᎦᎡᏂ	Other	ᎤᏍᎦᎡᏂ:Coward
ᎤᏍᎦᎢ	Other	ᎤᏍᎦᎢ:Genus: Iris Christata
ᎤᏍᎦᎩ	Other	ᎤᏍᎦᎩ:Enemy
ᎤᏍᎪᎸ	Other	ᎤᏍᎪᎸ:Pale
ᎤᏍᏆᏅᏂ	Other	ᎤᏍᏆᏅᏂ:Mulligan blanket
ᎤᏍᏆᏗ	Other	ᎤᏍᏆᏗ:Stick pin
ᎤᏍᏆᏙ	Other	ᎤᏍᏆᏙ:Genus: Aescolus L
ᎤᏍᏇᏅᎯ	Other	ᎤᏍᏇᏅᎯ:Fist
ᎤᏍᏓ	Immediate	ᎫᏍᏗᎭ:Mixing liquids
ᎤᏍᏓᎦᎸᎢ	Other	ᎤᏍᏓᎦᎸᎢ:Rock shelter
ᎤᏍᏓᎸᎢ	Other	ᎤᏍᏓᎸᎢ:Clan
ᎤᏍᏓᎾᎵ	Other	ᎤᏍᏓᎾᎵ:Shoals
ᎤᏍᏓᏁᎦᎸᎢ	Other	ᎤᏍᏓᏁᎦᎸᎢ:Sole of the foot
ᎤᏍᏓᏅᎢ	RemotePast	ᎫᏍᏗᎭ:Mixing liquids
ᎤᏍᏓᏍᏗ	Other	ᎤᏍᏓᏍᏗ:Mountain holly
ᎤᏍᏗ	Other	ᎤᏍᏗ:Little
ᎤᏍᏗᎢ	Other	ᎤᏍᏗᎢ:Baby
ᎤᏍᏗᎭ	PresentContinous	ᎫᏍᏗᎭ:Mixing liquids
ᎤᏍᏗᏍᎪᎢ	Habitual	ᎫᏍᏗᎭ:Mixing liquids
ᎤᏍᏗᏳ	Other	ᎤᏍᏗᏳ:Place to look
ᎤᏍᏙᏗ	Deverbal	ᎫᏍᏗᎭ:Mixing liquids
ᎤᏎᎳᏘ	Other	ᎤᏎᎳᏘ:Rattlesnake fern
ᎤᏎᏍᎩ	Other	ᎤᏎᏍᎩ:Whooping cough
ᎤᏐᏱ	Other	ᎤᏐᏱ:Same
ᎤᏑᎧᎸᎢ	Other	ᎤᏑᎧᎸᎢ:Toe nail
ᎤᏒᎯ	Other	ᎤᏒᎯ:Tonight
ᎤᏒᏙᏂ	Other	ᎤᏒᏙᏂ:Hollow
ᎤᏓᎳᎦ	Immediate	ᎫᏓᎳᎩᎠ:Unplugging it
ᎤᏓᎳᎩᎠ	PresentContinous	ᎫᏓᎳᎩᎠ:Unplugging it
ᎤᏓᎳᎩᏍᎪᎢ	Habitual	ᎫᏓᎳᎩᎠ:Unplugging it
ᎤᏓᎳᎩᏍᏗ	Deverbal	ᎫᏓᎳᎩᎠ:Unplugging it
ᎤᏓᎳᎩᏒᎢ	RemotePast	ᎫᏓᎳᎩᎠ:Unplugging it
ᎤᏓᎴᎯ	Other	ᎤᏓᎴᎯ:Different
ᎤᏓᎵ	Other	ᎤᏓᎵ:Mistletoe
ᎤᏓᎵᎢ	Other	ᎤᏓᎵᎢ:Wife
ᎤᏓᎶᏒ	Other	ᎤᏓᎶᏒ:Income
ᎤᏓᎸᎥᎦ	Immediate	ᎫᏓᎸᎥᏍᎦ:Plugging it in
ᎤᏓᎸᎥᏍᎦ	PresentContinous	ᎫᏓᎸᎥᏍᎦ:Plugging it in
ᎤᏓᎸᎥᏍᎪᎢ	Habitual	ᎫᏓᎸᎥᏍᎦ:Plugging it in
ᎤᏓᎸᏅᎢ	RemotePast	ᎫᏓᎸᎥᏍᎦ:Plugging it in
ᎤᏓᎸᏗ	Deverbal	ᎫᏓᎸᎥᏍᎦ:Plugging it in
ᎤᏓᏁᎦᎸᏓ	Other	ᎤᏓᏁᎦᎸᏓ:Sore
ᎤᏓᏁᎳᏬᏓ	Other	ᎤᏓᏁᎳᏬᏓ:Scalded
ᎤᏓᏁᎶᎲ	Other	ᎤᏓᏁᎶᎲ:Bush
ᎤᏓᏅᏙ	Other	ᎤᏓᏅᏙ:Heart
ᎤᏓᏔᏅᎯ	Other	ᎤᏓᏔᏅᎯ:Berry
ᎤᏓᏣᎧᏗ	Other	ᎤᏓᏣᎧᏗ:Rough
ᎤᏓᏪᎳᎩᏍᏗ	Other	ᎤᏓᏪᎳᎩᏍᏗ:Burner on a stove
ᎤᏔ	Immediate	ᎫᏘᎭ:Snowing
ᎤᏔᎦ	Immediate	ᎫᏔᎩᎠ:Picking up something long from the ground)
ᎤᏔᎩᎠ	PresentContinous	ᎫᏔᎩᎠ:Picking up something long from the ground)
ᎤᏔᎩᏍᎪᎢ	Habitual	ᎫᏔᎩᎠ:Picking up something long from the ground)
ᎤᏔᎩᏍᏗ	Deverbal	ᎫᏔᎩᎠ:Picking up something long from the ground)
ᎤᏔᎩᏒᎢ	RemotePast	ᎫᏔᎩᎠ:Picking up something long from the ground)
ᎤᏔᎭᏅᎢ	RemotePast	ᎫᏘᎭ:Snowing
ᎤᏔᎶᎩ	Other	ᎤᏔᎶᎩ:Open mouth (his)
ᎤᏔᎷᎩᏍᎩ	Other	ᎤᏔᎷᎩᏍᎩ:Satin
ᎤᏔᎾ	Other	ᎤᏔᎾ:Grown-up
ᎤᏕᏅ	Other	ᎤᏕᏅ:Birthplace
ᎤᏕᏗᏴᏌᏗᏒᎢ	Other	ᎤᏕᏗᏴᏌᏗᏒᎢ:Year
ᎤᏗ	Other	ᎤᏗ:Corn cob
ᎤᏗᎴᎩ	Other	ᎤᏗᎴᎩ:Fever
ᎤᏗᎴᎬᎢ	Other	ᎤᏗᎴᎬᎢ:Hot
ᎤᏗᎵᏍᏗ	Other	ᎤᏗᎵᏍᏗ:Genus: Smilacina Racemusa
ᎤᏘᎭ	PresentContinous	ᎫᏘᎭ:Snowing
ᎤᏘᎾᎢ	Other	ᎤᏘᎾᎢ:Father's brother's wife
ᎤᏘᏍᎪᎢ	Habitual	ᎫᏘᎭ:Snowing
ᎤᏙ	Other	ᎤᏙ:Sister's daughter
ᎤᏙᎯ	Other	ᎤᏙᎯ:Brother's sister (male ego)
ᎤᏙᎳᏂ	Other	ᎤᏙᎳᏂ:Serviceberry
ᎤᏙᎵ	Other	ᎤᏙᎵ:Penis
ᎤᏙᏓ	Other	ᎤᏙᏓ:Father's borther
ᎤᏙᏗ	Deverbal	ᎫᏘᎭ:Snowing
ᎤᏙᏗᏍᎬ	Other	ᎤᏙᏗᏍᎬ:Shade (in the)
ᎤᏙᏛᏆᏛ	Other	ᎤᏙᏛᏆᏛ:Day
ᎤᏙᏪᎸᎢ	Other	ᎤᏙᏪᎸᎢ:Birth mark
ᎤᏙᏳ	Other	ᎤᏙᏳ:Very
ᎤᏚᎢᏍᎦ	Other	ᎤᏚᎢᏍᎦ:Dotted
ᎤᏚᏚ	Other	ᎤᏚᏚ:Mother's father
ᎤᏚᏥ	Other	ᎤᏚᏥ:Uncle
ᎤᏛᎳᎦᏍᏛᏅ	Other	ᎤᏛᎳᎦᏍᏛᏅ:Broken bone
ᎤᏛᏃ	Other	ᎤᏛᏃ:Sheet sling used to carry a baby on one's back
ᎤᏛᏐᏅ	Other	ᎤᏛᏐᏅ:Man, elderly
ᎤᏣᎳ	Other	ᎤᏣᎳ:Pot scrapings
ᎤᏣᎴᏍᏗ	Other	ᎤᏣᎴᏍᏗ:Wheat bread
ᎤᏣᎾᎦ	Immediate	ᏕᎫᏣᎾᎩᎠ:Stretching
ᎤᏣᎾᎩᎠ	PresentContinous	ᏕᎫᏣᎾᎩᎠ:Stretching
ᎤᏣᎾᎩᏍᎪᎢ	Habitual	ᏕᎫᏣᎾᎩᎠ:Stretching
ᎤᏣᎾᎩᏍᏗ	Deverbal	ᏕᎫᏣᎾᎩᎠ:Stretching
ᎤᏣᎾᎩᏒᎢ	RemotePast	ᏕᎫᏣᎾᎩᎠ:Stretching
ᎤᏣᏘ	Other	ᎤᏣᏘ:Much
ᎤᏤᎵ	Other	ᎤᏤᎵ:Possession
ᎤᏤᏌᏗ	Other	ᎤᏤᏌᏗ:Overalls
ᎤᏤᏥᏍᏗ	Other	ᎤᏤᏥᏍᏗ:Opossum
ᎤᏥ	Other	ᎤᏥ:Mother
ᎤᏥᎸ	Other	ᎤᏥᎸ:Hot pepper
ᎤᏥᎹ	Other	ᎤᏥᎹ:Genus: Dumetella Carolinenois
ᎤᏥᏣᏗ	Other	ᎤᏥᏣᏗ:Corn tassel
ᎤᏦᎢ	Other	ᎤᏦᎢ:Daughter-in-law
ᎤᏦᎾᏗ	Other	ᎤᏦᎾᏗ:Rattlesnake
ᎤᏦᏁᏗ	Other	ᎤᏦᏁᏗ:Purple finch
ᎤᏦᏅᎯᏓ	Other	ᎤᏦᏅᎯᏓ:Soot
ᎤᏧᎩ	Other	ᎤᏧᎩ:Tufted titmouse
ᎤᏧᏬᏗ	Other	ᎤᏧᏬᏗ:Moccasin (snake? shoe?)
ᎤᏨᎬ	Other	ᎤᏨᎬ:Sickness
ᎤᏩᎦ	Other	ᎤᏩᎦ:Wild passion vine
ᎤᏩᎫᏩᏍᏗ	Other	ᎤᏩᎫᏩᏍᏗ:Hiccup
ᎤᏩᏂ	Other	ᎤᏩᏂ:Wool
ᎤᏩᏂᎦᎳᏅ	Other	ᎤᏩᏂᎦᎳᏅ:Limb
ᎤᏩᏌ	Other	ᎤᏩᏌ:Only one
ᎤᏩᏍᏗ	Other	ᎤᏩᏍᏗ:Ramps (plant)
ᎤᏪᎳ	Other	ᎤᏪᎳ:Liver
ᎤᏪᎳᎦᏏ	Other	ᎤᏪᎳᎦᏏ:Sibling-in-law
ᎤᏪᏅᏍᏛᎢ	Other	ᎤᏪᏅᏍᏛᎢ:Stem
ᎤᏪᏅᏒᎢ	Other	ᎤᏪᏅᏒᎢ:Home
ᎤᏪᏗ	Other	ᎤᏪᏗ:Old (inanimate only)
ᎤᏪᏘ	Other	ᎤᏪᏘ:Mole (on the flesh)
ᎤᏪᏛᎢ	Other	ᎤᏪᏛᎢ:Meander
ᎤᏪᏥ	Other	ᎤᏪᏥ:Egg
ᎤᏫᎾ	Other	ᎤᏫᎾ:Brother's sister's son
ᎤᏬᎩᎵ	Other	ᎤᏬᎩᎵ:Beer
ᎤᏬᎯᏳᏂ	Other	ᎤᏬᎯᏳᏂ:Obedient
ᎤᏬᏚᎯ	Other	ᎤᏬᏚᎯ:Pretty
ᎤᏬᏥᏗ	Other	ᎤᏬᏥᏗ:Funny
ᎤᏬᏰᏂ	Other	ᎤᏬᏰᏂ:Hand
ᎤᏯᎦ	Immediate	ᎫᏯᎩᎠ:Plucking a chicken
ᎤᏯᎩᎠ	PresentContinous	ᎫᏯᎩᎠ:Plucking a chicken
ᎤᏯᎩᎢᏍᏗ	Deverbal	ᎫᏯᎩᎠ:Plucking a chicken
ᎤᏯᎩᏍᎪᎢ	Habitual	ᎫᏯᎩᎠ:Plucking a chicken
ᎤᏯᎩᏒᎢ	RemotePast	ᎫᏯᎩᎠ:Plucking a chicken
ᎤᏯᎷᎦ	Other	ᎤᏯᎷᎦ:Bark of a tree
ᎤᏯᏍᎦ	Other	ᎤᏯᏍᎦ:Shell
ᎤᏯᏛᎲ	Other	ᎤᏯᏛᎲ:Frost on ground (white)
ᎤᏰᎯ	Other	ᎤᏰᎯ:Husband
ᎤᏰᎳᎭ	Other	ᎤᏰᎳᎭ:Nude
ᎤᏰᎶᎯᏎᎲᎢ	Other	ᎤᏰᎶᎯᏎᎲᎢ:Infection
ᎤᏰᏌᏛ	Other	ᎤᏰᏌᏛ:Dew on the ground
ᎤᏰᏑᎧᎸᎢ	Other	ᎤᏰᏑᎧᎸᎢ:Fingernail
ᎤᏰᏑᏨᏂ	Other	ᎤᏰᏑᏨᏂ:Wrist
ᎤᏲᎢ	Other	ᎤᏲᎢ:Bad
ᎤᏲᎾ	Other	ᎤᏲᎾ:Horn of an animal
ᎤᏲᏃᎪᏍᏓᎯ	Other	ᎤᏲᏃᎪᏍᏓᎯ:Bruise, to have a
ᎤᏲᏒᎯ	Other	ᎤᏲᏒᎯ:Dead
ᎤᏲᏓᎵ	Other	ᎤᏲᏓᎵ:Sweetflag
ᎤᏲᏓᎵᏳᏍᏗ	Other	ᎤᏲᏓᎵᏳᏍᏗ:Yellow twayblade
ᎤᏳᏍᏆᏗᏍᎬᎢ	Other	ᎤᏳᏍᏆᏗᏍᎬᎢ:Toothache
ᎤᏴᎰᏒᎯ	Other	ᎤᏴᎰᏒᎯ:Corpse
ᎤᏴᎳᏛ	Other	ᎤᏴᎳᏛ:Gap in the mountain
ᎤᏴᏍᏗ	Other	ᎤᏴᏍᏗ:Bitter
ᎤᏴᏘᏅᏔ	Other	ᎤᏴᏘᏅᏔ:Stem
ᎤᏴᏣ	Other	ᎤᏴᏣ:Cold
ᎥᎥ	Other	ᎥᎥ:Yes
ᎥᎦ	PresentContinous	ᎬᎦ:Something liquid (something flexible) (in)	ᎬᎩᎠ:Unravelling it	ᎠᎥᏍᎦ:Placing something solid on the ground
ᎥᎨᏍᏔ	Immediate	ᎬᎦ:Something liquid (something flexible) (in)
ᎥᎩᎠ	PresentContinous	ᎬᎩᎠ:Unravelling it
ᎥᎩᎶᎠ	PresentContinous	ᎬᎩᎶᎠ:Washing something alive
ᎥᎩᎶᎥᎢ	RemotePast	ᎬᎩᎶᎠ:Washing something alive
ᎥᎩᎶᏍᎪᎢ	Habitual	ᎬᎩᎶᎠ:Washing something alive
ᎥᎩᎶᏍᏗ	Deverbal	ᎬᎩᎶᎠ:Washing something flexible (c2)
ᎥᎩᎶᏣ	Immediate	ᎬᎩᎶᎠ:Washing something flexible (c2)
ᎥᎩᏍᎪᎢ	Habitual	ᎬᎩᎠ:Unravelling it
ᎥᎩᏍᏗ	Deverbal	ᎬᎩᎠ:Unravelling it
ᎥᎩᏒᎢ	RemotePast	ᎬᎩᎠ:Unravelling it
ᎥᎩᏣᎴᎠ	PresentContinous	ᎬᎩᏣᎴᎠ:Itching
ᎥᎩᏣᎴᎥᎢ	RemotePast	ᎬᎩᏣᎴᎠ:Itching
ᎥᎩᏣᎴᏍᎪᎢ	Habitual	ᎬᎩᏣᎴᎠ:Itching
ᎥᎩᏣᎴᏍᏗ	Deverbal	ᎬᎩᏣᎴᎠ:Itching
ᎥᎩᏣᎴᏣ	Immediate	ᎬᎩᏣᎴᎠ:Itching
ᎥᎪᎢ	Habitual	ᎬᎦ:Something liquid (something flexible) (in)
ᎥᎲᎦ	Immediate	ᏕᎬᏍᎦ:Putting something flexible into something liquid
ᎥᎴ	Other	ᎥᎴ:Seven year locust
ᎥᎾ	Immediate	ᎬᏍᎦ:Weaving
ᎥᎾᎦᎳᏬᎣᎠ	PresentContinous	ᏕᎬᎾᎦᎳᏬᎣᎠ:Pruning a tree
ᎥᎾᎦᎳᏬᎣᎥᎢ	RemotePast	ᏕᎬᎾᎦᎳᏬᎣᎠ:Pruning a tree
ᎥᎾᎦᎳᏬᎣᏍᎪᎢ	Habitual	ᏕᎬᎾᎦᎳᏬᎣᎠ:Pruning a tree
ᎥᎾᎦᎳᏬᎣᏍᏗ	Deverbal	ᏕᎬᎾᎦᎳᏬᎣᎠ:Pruning a tree
ᎥᎾᎦᎳᏬᎣᏣ	Immediate	ᏕᎬᎾᎦᎳᏬᎣᎠ:Pruning a tree
ᎥᎾᏘ	Other	ᎥᎾᏘ:Pottery
ᎥᎾᏬᏓ	Immediate	ᎬᎾᏬᏗᎭ:Frying it
ᎥᎾᏬᏔᏅᎢ	RemotePast	ᎬᎾᏬᏗᎭ:Frying it
ᎥᎾᏬᏗᎭ	PresentContinous	ᎬᎾᏬᏗᎭ:Frying it
ᎥᎾᏬᏗᏍᎪᎢ	Habitual	ᎬᎾᏬᏗᎭ:Frying it
ᎥᎾᏬᏙᏗ	Deverbal	ᎬᎾᏬᏗᎭ:Frying it
ᎥᏁᎦ	Immediate	ᏂᎬᏁᎭ:Making it
ᎥᏁᎭ	PresentContinous	ᏂᎬᏁᎭ:Making it
ᎥᏁᎰᎢ	Habitual	ᏂᎬᏁᎭ:Making something for him
ᎥᏁᎸᎢ	RemotePast	ᏂᎬᏁᎭ:Making something for him
ᎥᏂᎭ	Immediate	ᎬᏂᏍᎦ:Cooking
ᎥᏂᏍᎦ	PresentContinous	ᎬᏂᏍᎦ:Cooking
ᎥᏂᏍᎪᎢ	Habitual	ᎬᏂᏍᎦ:Cooking
ᎥᏂᏍᏗ	Deverbal	ᎬᏂᏍᎦ:Cooking
ᎥᏂᏒᎢ	RemotePast	ᎬᏂᏍᎦ:Cooking
ᎥᏃᏌ	Immediate	ᎬᏃᏌᏍᎦ:Sweeping
ᎥᏃᏌᎲᎢ	RemotePast	ᎬᏃᏌᏍᎦ:Sweeping
ᎥᏃᏌᏍᎦ	PresentContinous	ᎬᏃᏌᏍᎦ:Sweeping
ᎥᏃᏌᏍᎪᎢ	Habitual	ᎬᏃᏌᏍᎦ:Sweeping
ᎥᏃᏌᏍᏗ	Deverbal	ᎬᏃᏌᏍᎦ:Sweeping
ᎥᏄᏯᎦ	Immediate	ᎬᏄᏯᎩᎠ:Pulling up weeds
ᎥᏄᏯᎩᎠ	PresentContinous	ᎬᏄᏯᎩᎠ:Pulling up weeds
ᎥᏄᏯᎩᏍᎪᎢ	Habitual	ᎬᏄᏯᎩᎠ:Pulling up weeds
ᎥᏄᏯᎬᎥᎢ	RemotePast	ᎬᏄᏯᎩᎠ:Pulling up weeds
ᎥᏄᏯᎬᏗ	Deverbal	ᎬᏄᏯᎩᎠ:Pulling up weeds
ᎥᏅᎢ	RemotePast	ᎬᏍᎦ:Weaving	ᎬᎦ:Something liquid (something flexible) (in)	ᏕᎬᏍᎦ:Putting something flexible into something liquid
ᎥᏌ	Immediate	ᎠᎥᏏ:Handing something solid to him
ᎥᏍᎦ	PresentContinous	ᎠᎥᏍᎦ:Placing something solid on the ground	ᎬᏍᎦ:Weaving	ᏕᎬᏍᎦ:Putting something flexible into something liquid
ᎥᏍᎦᎳᎦ	Immediate	ᎬᏍᎦᎳᏍᎦ:Hiding something solid
ᎥᏍᎦᎳᏅᎢ	RemotePast	ᎬᏍᎦᎳᏍᎦ:Hiding something solid
ᎥᏍᎦᎳᏍᎦ	PresentContinous	ᎬᏍᎦᎳᏍᎦ:Hiding something solid
ᎥᏍᎦᎳᏍᎪᎢ	Habitual	ᎬᏍᎦᎳᏍᎦ:Hiding something solid
ᎥᏍᎦᎳᏓ	Immediate	ᎬᏍᎦᎳᏗᎠ:Hiding something long
ᎥᏍᎦᎳᏗ	Deverbal	ᎬᏍᎦᎳᏍᎦ:Hiding something solid
ᎥᏍᎦᎳᏗᎠ	PresentContinous	ᎬᏍᎦᎳᏗᎠ:Hiding something long
ᎥᏍᎦᎳᏗᏍᎪᎢ	Habitual	ᎬᏍᎦᎳᏗᎠ:Hiding something long
ᎥᏍᎦᎳᏗᏍᏗ	Deverbal	ᎬᏍᎦᎳᏗᎠ:Hiding something long
ᎥᏍᎦᎳᏛᎢ	RemotePast	ᎬᏍᎦᎳᏗᎠ:Hiding something long
ᎥᏍᎦᎸᎥᎦ	Immediate	ᎬᏍᎦᎸᎥᏍᎦ:Hiding something flexible
ᎥᏍᎦᎸᎥᏍᎦ	PresentContinous	ᎬᏍᎦᎸᎥᏍᎦ:Hiding something flexible
ᎥᏍᎦᎸᎥᏍᎪᎢ	Habitual	ᎬᏍᎦᎸᎥᏍᎦ:Hiding something flexible
ᎥᏍᎦᎸᏅᎢ	RemotePast	ᎬᏍᎦᎸᎥᏍᎦ:Hiding something flexible
ᎥᏍᎦᎸᏗ	Deverbal	ᎬᏍᎦᎸᎥᏍᎦ:Hiding something flexible
ᎥᏍᎩᏱ	Other	ᎥᏍᎩᏱ:December
ᎥᏍᎪᎢ	Habitual	ᎬᏍᎦ:Weaving	ᏕᎬᏍᎦ:Putting something flexible into something liquid	ᎠᎥᏍᎦ:Placing something solid on the ground
ᎥᏍᏆᎶᎠ	PresentContinous	ᎬᏍᏆᎶᎠ:Cracking it
ᎥᏍᏆᎶᎥᎢ	RemotePast	ᎬᏍᏆᎶᎠ:Cracking it
ᎥᏍᏆᎶᏍᎪᎢ	Habitual	ᎬᏍᏆᎶᎠ:Cracking it
ᎥᏍᏆᎶᏍᏗ	Deverbal	ᎬᏍᏆᎶᎠ:Cracking it
ᎥᏍᏆᎶᏣ	Immediate	ᎬᏍᏆᎶᎠ:Cracking it
ᎥᏍᏗ	Deverbal	ᎠᎥᏍᎦ:Placing something solid on the ground
ᎥᏏ	PresentContinous	ᎠᎥᏏ:Handing something solid to him
ᎥᏓ	Immediate	ᎬᏗᎭ:Using it
ᎥᏓᎦ	Immediate	ᎬᏓᎩᎠ:Taking something solid off of a fire
ᎥᏓᎩᎠ	PresentContinous	ᎬᏓᎩᎠ:Taking something solid off of a fire
ᎥᏓᎩᏍᎪᎢ	Habitual	ᎬᏓᎩᎠ:Taking something solid off of a fire
ᎥᏓᎩᏍᏗ	Deverbal	ᎬᏓᎩᎠ:Taking something solid off of a fire
ᎥᏓᎩᏒᎢ	RemotePast	ᎬᏓᎩᎠ:Taking something solid off of a fire
ᎥᏓᎵᏓ	Immediate	ᎬᏓᎵᏗᎠ:Turning off a light
ᎥᏓᎵᏗᎠ	PresentContinous	ᎬᏓᎵᏗᎠ:Turning off a light
ᎥᏓᎵᏗᏍᎪᎢ	Habitual	ᎬᏓᎵᏗᎠ:Turning off a light
ᎥᏓᎵᏗᏍᏗ	Deverbal	ᎬᏓᎵᏗᎠ:Turning off a light
ᎥᏓᎵᏛᎢ	RemotePast	ᎬᏓᎵᏗᎠ:Turning off a light
ᎥᏓᎶᎭ	Immediate	ᎬᏓᎶᏍᎦ:Light going out
ᎥᏓᎶᎯᏍᏗ	Deverbal	ᎬᏓᎶᏍᎦ:Light going out
ᎥᏓᎶᏍᎦ	PresentContinous	ᎬᏓᎶᏍᎦ:Light going out
ᎥᏓᎶᏍᎪᎢ	Habitual	ᎬᏓᎶᏍᎦ:Light going out
ᎥᏓᎶᏒᎢ	RemotePast	ᎬᏓᎶᏍᎦ:Light going out
ᎥᏔᎦ	Immediate	ᎬᏔᏍᎦ:Placing something solid in a fire
ᎥᏔᏅᎢ	RemotePast	ᎬᏗᎭ:Using it	ᎬᏔᏍᎦ:Placing something solid in a fire
ᎥᏔᏍᎦ	PresentContinous	ᎬᏔᏍᎦ:Placing something solid in a fire
ᎥᏔᏍᎪᎢ	Habitual	ᎬᏔᏍᎦ:Placing something solid in a fire
ᎥᏗ	Deverbal	ᏕᎬᏍᎦ:Putting something flexible into something liquid	ᎬᎦ:Something liquid (something flexible) (in)	ᎬᏍᎦ:Weaving
ᎥᏗᎭ	PresentContinous	ᎬᏗᎭ:Using it
ᎥᏗᏍᎪᎢ	Habitual	ᎬᏗᎭ:Using it
ᎥᏗᏯ	Immediate	ᏕᎬᏗᏰᎠ:Washing dishes
ᎥᏗᏰᎠ	PresentContinous	ᏕᎬᏗᏰᎠ:Washing dishes
ᎥᏗᏰᎥᎢ	RemotePast	ᏕᎬᏗᏰᎠ:Washing dishes
ᎥᏗᏰᏍᎪᎢ	Habitual	ᏕᎬᏗᏰᎠ:Washing dishes
ᎥᏗᏰᏗ	Deverbal	ᏕᎬᏗᏰᎠ:Washing dishes
ᎥᏘᏗ	Deverbal	ᎬᏔᏍᎦ:Placing something solid in a fire
ᎥᏙᎦ	Immediate	ᎬᏙᎩᎠ:Shelling (peas)
ᎥᏙᎩᎠ	PresentContinous	ᎬᏙᎩᎠ:Shelling (peas)
ᎥᏙᎩᏍᎪᎢ	Habitual	ᎬᏙᎩᎠ:Shelling (peas)
ᎥᏙᎩᏍᏗ	Deverbal	ᎬᏙᎩᎠ:Shelling (peas)
ᎥᏙᎩᏒᎢ	RemotePast	ᎬᏙᎩᎠ:Shelling (peas)
ᎥᏙᏗ	Deverbal	ᎬᏗᎭ:Using it
ᎥᏛᎥᎦ	Immediate	ᎬᏛᎥᏍᎦ:Putting something flexible into a fire
ᎥᏛᎥᏍᎦ	PresentContinous	ᎬᏛᎥᏍᎦ:Putting something flexible into a fire
ᎥᏛᎥᏍᎪᎢ	Habitual	ᎬᏛᎥᏍᎦ:Putting something flexible into a fire
ᎥᏛᎦ	Immediate	ᎬᏛᎩᎠ:Taking something flexible from a fire
ᎥᏛᎩᎠ	PresentContinous	ᎬᏛᎩᎠ:Taking something flexible from a fire
ᎥᏛᎩᏍᎪᎢ	Habitual	ᎬᏛᎩᎠ:Taking something flexible from a fire
ᎥᏛᎩᏍᏗ	Deverbal	ᎬᏛᎩᎠ:Taking something flexible from a fire
ᎥᏛᎩᏒᎢ	RemotePast	ᎬᏛᎩᎠ:Taking something flexible from a fire
ᎥᏛᏅᎢ	RemotePast	ᎬᏛᎥᏍᎦ:Putting something flexible into a fire
ᎥᏛᏗ	Deverbal	ᎬᏛᎥᏍᎦ:Putting something flexible into a fire
ᎥᏣᎳᎦ	Immediate	ᏕᎬᏣᎳᏍᎦ:Frying meat
ᎥᏣᎳᏅᎢ	RemotePast	ᏕᎬᏣᎳᏍᎦ:Frying meat
ᎥᏣᎳᏍᎦ	PresentContinous	ᏕᎬᏣᎳᏍᎦ:Frying meat
ᎥᏣᎳᏍᎪᎢ	Habitual	ᏕᎬᏣᎳᏍᎦ:Frying meat
ᎥᏣᎳᏗ	Deverbal	ᏕᎬᏣᎳᏍᎦ:Frying meat
ᎥᏩᎳᎦ	Immediate	ᎬᏩᎳᏍᎦ:Soaking it
ᎥᏩᎳᏅᎢ	RemotePast	ᎬᏩᎳᏍᎦ:Soaking it
ᎥᏩᎳᏍᎦ	PresentContinous	ᎬᏩᎳᏍᎦ:Soaking it
ᎥᏩᎳᏍᎪᎢ	Habitual	ᎬᏩᎳᏍᎦ:Soaking it
ᎥᏩᎳᏗ	Deverbal	ᎬᏩᎳᏍᎦ:Soaking it
ᎥᏩᏁᏍᏗ	Deverbal	ᏂᎬᏁᎭ:Making something for him
ᎥᏩᏗ	Deverbal	ᏂᎬᏁᎭ:Making it
ᎥᏴᎩᎶᏣ	Immediate	ᎬᎩᎶᎠ:Washing something alive
ᎥᏴᏁᏌ	Immediate	ᏂᎬᏁᎭ:Making something for him
Ꭶ	Immediate	ᎠᎩᎠ:Picking up something solid
ᎦᎦᎶ	Other	ᎦᎦᎶ:Ham (whole)
ᎦᎦᎷᎢ	Other	ᎦᎦᎷᎢ:Thigh
ᎦᎦᎹ	Other	ᎦᎦᎹ:Genus: Cucumis Sativus
ᎦᎦᏆᎴᏂ	Other	ᎦᎦᏆᎴᏂ:Cheek
ᎦᎦᏛᏓ	Other	ᎦᎦᏛᏓ:Taboo
ᎦᎩᎵᎨᏂ	Other	ᎦᎩᎵᎨᏂ:Neck (back of)
ᎦᎭᏗ	Other	ᎦᎭᏗ:Wedge
ᎦᎱᏍᏗ	Other	ᎦᎱᏍᏗ:Something
ᎦᎳᎩᎾ	Other	ᎦᎳᎩᎾ:Stag
ᎦᎳᏗᏍᏙᏗ	Other	ᎦᎳᏗᏍᏙᏗ:Container for something long
ᎦᎴᎩ	Other	ᎦᎴᎩ:Genus: Elaphe Obsoleta
ᎦᎴᏂ	Other	ᎦᎴᏂ:Ear
ᎦᎵᎢᏍᏗ	Deverbal	ᎠᎦᎵᏍᎦ:Cutting off something flexible
ᎦᎵᎦ	Immediate	ᎠᎦᎵᏍᎦ:Cutting off something flexible
ᎦᎵᎦᎵ	Other	ᎦᎵᎦᎵ:February
ᎦᎵᎬ	Other	ᎦᎵᎬ:Fire, uncontrolled
ᎦᎵᏆᏍᎪᎯ	Other	ᎦᎵᏆᏍᎪᎯ:Seventy
ᎦᎵᏆᏚ	Other	ᎦᎵᏆᏚ:Seventeen
ᎦᎵᏉᎩ	Other	ᎦᎵᏉᎩ:Seven
ᎦᎵᏍᎦ	PresentContinous	ᎠᎦᎵᏍᎦ:Cutting off something flexible
ᎦᎵᏍᎪᎢ	Habitual	ᎠᎦᎵᏍᎦ:Cutting off something flexible
ᎦᎵᏒᎢ	RemotePast	ᎠᎦᎵᏍᎦ:Cutting off something flexible
ᎦᎵᏔᏅᏙᏗ	Other	ᎦᎵᏔᏅᏙᏗ:Container for solid items
ᎦᎵᏣᏗ	Other	ᎦᎵᏣᏗ:Bow
ᎦᎵᏦᎯᏓ	Other	ᎦᎵᏦᎯᏓ:Fat
ᎦᎵᏦᏕ	Other	ᎦᎵᏦᏕ:House
ᎦᎶᎪᏗ	Other	ᎦᎶᎪᏗ:Hoe
ᎦᎶᎯ	Other	ᎦᎶᎯ:Cullowhee, NC
ᎦᎶᎯᏍᏗ	Other	ᎦᎶᎯᏍᏗ:Doorway
ᎦᎶᏂ	Other	ᎦᎶᏂ:August
ᎦᎶᏱᏍᏗ	Other	ᎦᎶᏱᏍᏗ:Axe
ᎦᎸᎳᏗ	Other	ᎦᎸᎳᏗ:Upstairs
ᎦᎸᎳᏗᏣ	Other	ᎦᎸᎳᏗᏣ:Upward
ᎦᎸᎶᎢ	Other	ᎦᎸᎶᎢ:Sky
ᎦᎸᎾ	Other	ᎦᎸᎾ:Gourd
ᎦᎸᏙᎵ	Other	ᎦᎸᏙᎵ:Tall and skinny
ᎦᎸᏙᏗ	Other	ᎦᎸᏙᏗ:Container for something flexible
ᎦᎾ	Immediate	ᎤᎦᏍᎦ:Being rained on
ᎦᎾᎦᏗ	Other	ᎦᎾᎦᏗ:Doctor
ᎦᎾᎦᏙ	Other	ᎦᎾᎦᏙ:Hospital
ᎦᎾᎩᎸᎢ	Other	ᎦᎾᎩᎸᎢ:House
ᎦᎾᏁᏍᎩ	Other	ᎦᎾᏁᏍᎩ:Spider
ᎦᎾᏅᎢ	RemotePast	ᎤᎦᏍᎦ:Being rained on
ᎦᎾᏌ	Other	ᎦᎾᏌ:Tame
ᎦᎾᏌᏛᎢ	Other	ᎦᎾᏌᏛᎢ:Toe
ᎦᎾᏍᏚᎩ	Other	ᎦᎾᏍᏚᎩ:Washington, DC
ᎦᎾᏑᎦᎸᎢ	Other	ᎦᎾᏑᎦᎸᎢ:Wall
ᎦᎾᏑᏛᎶ	Other	ᎦᎾᏑᏛᎶ:Witch hazel
ᎦᎾᏗ	Deverbal	ᎤᎦᏍᎦ:Being rained on
ᎦᎾᏚᏍᎩ	Other	ᎦᎾᏚᏍᎩ:Vendor
ᎦᎾᏤᏗ	Other	ᎦᎾᏤᏗ:Rattle
ᎦᎾᏫᎯ	Other	ᎦᎾᏫᎯ:Heart
ᎦᏁᎲᎢ	Other	ᎦᏁᎲᎢ:Puddle
ᎦᏁᎳᏗ	Other	ᎦᏁᎳᏗ:Pregnant
ᎦᏁᎵᏗᎭ	Other	ᎦᏁᎵᏗᎭ:Try
ᎦᏁᏃᏗᏍᎩ	Other	ᎦᏁᏃᏗᏍᎩ:Measles
ᎦᏁᏏ	Other	ᎦᏁᏏ:Golden club
ᎦᏁᏐᎸᏍᏙᏗ	Other	ᎦᏁᏐᎸᏍᏙᏗ:Strainer
ᎦᏁᏗᏍᎩ	Other	ᎦᏁᏗᏍᎩ:River birch
ᎦᏁᏥᎢ	Other	ᎦᏁᏥᎢ:Chest (of the body)
ᎦᏁᏥᏗᏍᎩ	Other	ᎦᏁᏥᏗᏍᎩ:Interpreter
ᎦᏂ	Other	ᎦᏂ:Mountain can
ᎦᏂᎨᏂ	Other	ᎦᏂᎨᏂ:Knee
ᎦᏂᎩᏓ	Other	ᎦᏂᎩᏓ:Not any
ᎦᏂᎪᎢ	Other	ᎦᏂᎪᎢ:Tongue
ᎦᏂᏌᎲᎢ	Other	ᎦᏂᏌᎲᎢ:Burial
ᎦᏂᏏ	Other	ᎦᏂᏏ:Bed
ᎦᏂᏒᏱ	Other	ᎦᏂᏒᏱ:Under the house
ᎦᏃᎨᏂ	Other	ᎦᏃᎨᏂ:Arm
ᎦᏃᎮᎾ	Other	ᎦᏃᎮᎾ:Rice
ᎦᏃᎮᏂ	Other	ᎦᏃᎮᏂ:Hominy grits
ᎦᏄᎯᎵᏗ	Other	ᎦᏄᎯᎵᏗ:Plate
ᎦᏄᎱᎵᏗ	Other	ᎦᏄᎱᎵᏗ:Cup
ᎦᏄᎸᎯ	Other	ᎦᏄᎸᎯ:Grass
ᎦᏅᎩ	Other	ᎦᏅᎩ:Genus: Pendroica Fusca
ᎦᏅᎯᏓ	Other	ᎦᏅᎯᏓ:Long
ᎦᏅᏃᏩ	Other	ᎦᏅᏃᏩ:Pipe use for smoking
ᎦᏅᏅ	Other	ᎦᏅᏅ:Road
ᎦᏅᏆᎶᏍᏗ	Other	ᎦᏅᏆᎶᏍᏗ:Hammer
ᎦᏅᏍᎨᏂ	Other	ᎦᏅᏍᎨᏂ:Leg
ᎦᏅᏒᏨᎢ	Other	ᎦᏅᏒᏨᎢ:Ankle
ᎦᏅᏙᎧ	Other	ᎦᏅᏙᎧ:Tooth
ᎦᏅᏙᎩ	Other	ᎦᏅᏙᎩ:Saw
ᎦᏆᏒᎦ	Other	ᎦᏆᏒᎦ:Smelly
ᎦᏌᎴᎾ	Other	ᎦᏌᎴᎾ:Sweater
ᎦᏍᎦ	PresentContinous	ᎤᎦᏍᎦ:Being rained on
ᎦᏍᎨᏂ	Other	ᎦᏍᎨᏂ:Armpit
ᎦᏍᎩᎶᎯ	Other	ᎦᏍᎩᎶᎯ:Chair
ᎦᏍᎩᎸᎢ	Other	ᎦᏍᎩᎸᎢ:Table
ᎦᏍᎪᎢ	Habitual	ᎤᎦᏍᎦ:Being rained on
ᎦᏍᏓᎨᏂ	Other	ᎦᏍᏓᎨᏂ:Calf of the leg
ᎦᏐᎯᎢ	Other	ᎦᏐᎯᎢ:Upper back
ᎦᏑᎲᏍᎦ	PresentContinous	ᎤᎦᏑᎲᏍᎦ:Getting something in his eye
ᎦᏑᎲᏍᎪᎢ	Habitual	ᎤᎦᏑᎲᏍᎦ:Getting something in his eye
ᎦᏑᎿ	Immediate	ᎤᎦᏑᎲᏍᎦ:Getting something in his eye
ᎦᏑᏅᎢ	RemotePast	ᎤᎦᏑᎲᏍᎦ:Getting something in his eye
ᎦᏑᏗ	Deverbal	ᎤᎦᏑᎲᏍᎦ:Getting something in his eye
ᎦᏒᎾᎵ	Other	ᎦᏒᎾᎵ:Roof
ᎦᏒᏍᏓ	Immediate	ᏓᎦᏒᏍᏗᎭ:Smoking
ᎦᏒᏍᏓᏅᎢ	RemotePast	ᏓᎦᏒᏍᏗᎭ:Smoking
ᎦᏒᏍᏗᎭ	PresentContinous	ᏓᎦᏒᏍᏗᎭ:Smoking
ᎦᏒᏍᏗᏍᎪᎢ	Habitual	ᏓᎦᏒᏍᏗᎭ:Smoking
ᎦᏒᏍᏙᏗ	Deverbal	ᏓᎦᏒᏍᏗᎭ:Smoking
ᎦᏓ	Other	ᎦᏓ:Dirt
ᎦᏓᎫᎦ	Other	ᎦᏓᎫᎦ:Jug
ᎦᏓᎭ	Other	ᎦᏓᎭ:Dirty
ᎦᏓᎵᏓ	Other	ᎦᏓᎵᏓ:Arrow
ᎦᏓᏆᎵ	Other	ᎦᏓᏆᎵ:Clay
ᎦᏓᏘ	Other	ᎦᏓᏘ:Flag
ᎦᏓᏲᏍᏗ	Other	ᎦᏓᏲᏍᏗ:Marble
ᎦᏔᎭ	PresentContinous	ᎠᎦᏔᎭ:Knowing it
ᎦᏔᎰᎢ	Habitual	ᎠᎦᏔᎭ:Knowing it
ᎦᏔᎳ	Immediate	ᏓᎦᏔᎵᎭ:Shelling corn
ᎦᏔᎵᎭ	PresentContinous	ᏓᎦᏔᎵᎭ:Shelling corn
ᎦᏔᎵᏍᎪᎢ	Habitual	ᏓᎦᏔᎵᎭ:Shelling corn
ᎦᏔᎵᏗ	Deverbal	ᏓᎦᏔᎵᎭ:Shelling corn
ᎦᏔᎸᎲᎢ	RemotePast	ᏓᎦᏔᎵᎭ:Shelling corn
ᎦᏖᏌᏗ	Other	ᎦᏖᏌᏗ:Skillet
ᎦᏖᏍᎨᏂ	Other	ᎦᏖᏍᎨᏂ:Back, lower (body pt)
ᎦᏖᏍᏔ	Immediate	ᏩᎦᏘ:Going somewhere
ᎦᏖᏍᏗ	Deverbal	ᏩᎦᏘ:Going somewhere
ᎦᏖᏍᏛᎢ	RemotePast	ᏩᎦᏘ:Going somewhere
ᎦᏗᎨᏂ	Other	ᎦᏗᎨᏂ:Heel (of foot)
ᎦᏘ	PresentContinous	ᏩᎦᏘ:Going somewhere
ᎦᏘᏔ	Immediate	ᎠᎦᏘᏯ:Waiting
ᎦᏘᏗᏍᏗ	Deverbal	ᎠᎦᏘᏯ:Waiting
ᎦᏘᏛᎢ	RemotePast	ᎠᎦᏘᏯ:Waiting
ᎦᏘᏯ	PresentContinous	ᎠᎦᏘᏯ:Waiting
ᎦᏘᏲᎢ	Habitual	ᎠᎦᏘᏯ:Waiting
ᎦᏙ	Other	ᏙᎢᏳᏍᏗ:What
ᎦᏙᎢ	Habitual	ᏩᎦᏘ:Going somewhere
ᎦᏙᏌᏗᏍᏙᏗ	Other	ᎦᏙᏌᏗᏍᏙᏗ:Hinge, hinges
ᎦᏚ	Other	ᎦᏚ:Bread
ᎦᏚᎩ	Other	ᎦᏚᎩ:Free labor company
ᎦᏚᎳᏍᏗ	Other	ᎦᏚᎳᏍᏗ:Dough
ᎦᏚᏏ	Other	ᎦᏚᏏ:Up the mountain
ᎦᏛᎴᎭ	Immediate	ᎠᎦᏛᎴᎭ:Passing grade
ᎦᏛᎴᏍᎪᎢ	Habitual	ᎠᎦᏛᎴᎭ:Passing grade
ᎦᏛᎴᏍᏗ	Deverbal	ᎠᎦᏛᎴᎭ:Passing grade
ᎦᏛᎴᏒᎢ	RemotePast	ᎠᎦᏛᎴᎭ:Passing grade
ᎦᏛᏗ	Other	ᎦᏛᏗ:Fishing pole
ᎦᏤᎷᎩᏍᏙᏗ	Other	ᎦᏤᎷᎩᏍᏙᏗ:Horn
ᎦᏨ	Other	ᎦᏨ:Where
ᎦᏨᏄᎳ	Other	ᎦᏨᏄᎳ:Quick
ᎦᏩᏒᎩ	Other	ᎦᏩᏒᎩ:Genus: Cucumis Melo
ᎦᏬᏍᎬ	Other	ᎦᏬᏍᎬ:Ulcer
ᎦᏯᎴᎾ	Other	ᎦᏯᎴᎾ:North Carolina
ᎦᏯᎸᏗ	Other	ᎦᏯᎸᏗ:Postage stamp
ᎦᏯᏍᏆᎴᏅ	Other	ᎦᏯᏍᏆᎴᏅ:Rose-breasted grosbeek
ᎦᏰᏈᏍᎬᎢ	Other	ᎦᏰᏈᏍᎬᎢ:Stitch
ᎦᏰᏫᏒᎥᏍᎩ	Other	ᎦᏰᏫᏒᎥᏍᎩ:Sewing machine
ᎦᏲᎵ	Other	ᎦᏲᎵ:Little
ᎦᏳᎳ	Other	ᎦᏳᎳ:Already
ᎦᏴᎱᎶ	Other	ᎦᏴᎱᎶ:Saddle
ᎧᎣᏗ	Deverbal	ᎦᎧᎲᏍᎦ:Setting up
ᎧᎥᏍᏔ	Immediate	ᎠᎧᏁᎭ:Giving something alive to him
ᎧᎩᏳᏍᏗ	Other	ᎧᎩᏳᏍᏗ:Who is it?
ᎧᎪ	Other	ᎧᎪ:Who?
ᎧᎭ	PresentContinous	ᎤᎧᎭ:Has something alive
ᎧᎮᏍᏔ	Immediate	ᎤᎧᎭ:Has something alive
ᎧᎮᏍᏛᎢ	RemotePast	ᎤᎧᎭ:Has something alive
ᎧᎯᏯ	Immediate	ᎠᎧᎯᏱᎠ:Leaving something alive
ᎧᎯᏱᎠ	PresentContinous	ᎠᎧᎯᏱᎠ:Leaving something alive
ᎧᎯᏱᏍᎪᎢ	Habitual	ᎠᎧᎯᏱᎠ:Leaving something alive
ᎧᎯᏱᏍᏗ	Deverbal	ᎠᎧᎯᏱᎠ:Leaving something alive
ᎧᎯᏴᎢ	RemotePast	ᎠᎧᎯᏱᎠ:Leaving something alive
ᎧᎰᎢ	Habitual	ᎤᎧᎭ:Has something alive
ᎧᎲᎠ	PresentContinous	ᎠᎧᎲᎠ:Moving something alive
ᎧᎲᎦ	Immediate	ᎦᎧᎲᏍᎦ:Setting up
ᎧᎲᎾ	Immediate	ᎠᎧᎲᎠ:Moving something solid
ᎧᎲᏍᎦ	PresentContinous	ᎦᎧᎲᏍᎦ:Setting up
ᎧᎲᏍᎪᎢ	Habitual	ᎠᎧᎲᎠ:Moving something solid	ᎦᎧᎲᏍᎦ:Setting up
ᎧᎲᏍᏗ	Deverbal	ᎠᎧᎲᎠ:Pushing something alive aside
ᎧᎲᏒᎢ	RemotePast	ᎠᎧᎲᎠ:Moving something alive
ᎧᎵᎢᎭ	PresentContinous	ᎠᎧᎵᎢᎭ:Filling
ᎧᎵᎢᎰᎢ	Habitual	ᎠᎧᎵᎢᎭ:Filling
ᎧᎵᎢᏍᏗ	Deverbal	ᎠᎧᎵᎢᎭ:Filling
ᎧᎵᎸᎢ	RemotePast	ᎠᎧᎵᎢᎭ:Filling
ᎧᎵᏎᏥ	Other	ᎧᎵᏎᏥ:Sugar
ᎧᎵᏣ	Immediate	ᎠᎧᎵᎢᎭ:Filling
ᎧᎶᏇᏗ	Other	ᎧᎶᏇᏗ:Gun
ᎧᎸᎬᎢ	Other	ᎧᎸᎬᎢ:East
ᎧᎹᎹ	Other	ᎧᎹᎹ:Elephant
ᎧᎾ	PresentContinous	ᏓᎧᎾ:Looking at
ᎧᎾᎠ	PresentContinous	ᎤᎧᎾᎠ:Has livestock or animals
ᎧᎾᎣᎢ	Habitual	ᎤᎧᎾᎠ:Has livestock or animals
ᎧᎾᎦ	Immediate	ᏓᎧᎾ:Looking at
ᎧᎾᎫᏣᏘ	Other	ᎧᎾᎫᏣᏘ:Turk's cap lily
ᎧᎾᏁᏍᎩ	Other	ᎧᎾᏁᏍᎩ:Spider
ᎧᎾᏅᎢ	RemotePast	ᏓᎧᎾ:Looking at
ᎧᎾᏍᎦᏫ	Other	ᎧᎾᏍᎦᏫ:Genus: Family Gruidae
ᎧᎾᏍᏓᏥ	Other	ᎧᎾᏍᏓᏥ:Sassafras
ᎧᎾᏗ	Deverbal	ᏓᎧᎾ:Looking at
ᎧᎾᏥᏍᏕᏥ	Other	ᎧᎾᏥᏍᏕᏥ:Wasp
ᎧᏁᎥᏍᏗ	Deverbal	ᏓᎧᏁᎦ:Placing living things in a row
ᎧᏁᎦ	PresentContinous	ᏓᎧᏁᎦ:Placing living things in a row
ᎧᏁᎪᎢ	Habitual	ᏓᎧᏁᎦ:Placing living things in a row
ᎧᏁᎭ	PresentContinous	ᎠᎧᏁᎭ:Giving something alive to him
ᎧᏁᎰᎢ	Habitual	ᎠᎧᏁᎭ:Giving something alive to him
ᎧᏁᎵ	PresentContinous	ᎠᎧᏁᎵ:Taking something alive to him
ᎧᏁᎵᏐᎢ	Habitual	ᎠᎧᏁᎵ:Taking something alive to him
ᎧᏁᎵᏗ	Deverbal	ᎠᎧᏁᎵ:Taking something alive to him
ᎧᏁᎷᎦ	Immediate	ᎠᎧᏁᎵ:Taking something alive to him
ᎧᏁᎸᎢ	RemotePast	ᎠᎧᏁᎭ:Giving something alive to him	ᎠᎧᏁᎵ:Taking something alive to him
ᎧᏁᏉᏓ	Other	ᎧᏁᏉᏓ:Genus: Agkistrodon Piscivorus
ᎧᏁᏌ	Other	ᎧᏁᏌ:Box
ᎧᏁᏍᎦ	Other	ᎧᏁᏍᎦ:Hay
ᎧᏁᏒᎢ	RemotePast	ᎠᎧᏂ:Returning an animal	ᏓᎧᏁᎦ:Placing living things in a row
ᎧᏁᏗ	Deverbal	ᎠᎧᏁᎭ:Giving something alive to him
ᎧᏂ	PresentContinous	ᎠᎧᏂ:Returning an animal	ᎤᎧᎾᎠ:Has livestock or animals
ᎧᏂᎩᏓ	Other	ᎧᏂᎩᏓ:Nothing
ᎧᏂᎭ	PresentContinous	ᏓᎧᏂᎭ:Tying
ᎧᏂᎰᎢ	Habitual	ᏓᎧᏂᎭ:Tying
ᎧᏂᎸᎢ	RemotePast	ᏓᎧᏂᎭ:Tying
ᎧᏂᏍᎦᏩ	Other	ᎧᏂᏍᎦᏩ:Genus: Ardla Herodias
ᎧᏂᏍᏗ	Deverbal	ᏓᎧᏂᎭ:Tying
ᎧᏂᏐᎢ	Habitual	ᎠᎧᏂ:Returning an animal
ᎧᏂᏣ	Immediate	ᏓᎧᏂᎭ:Tying
ᎧᏃᎢ	Habitual	ᏓᎧᎾ:Looking at
ᎧᏃᎩᏍᏗ	Other	ᎧᏃᎩᏍᏗ:Song
ᎧᏃᎩᏍᏙᏗ	Other	ᎧᏃᎩᏍᏙᏗ:Musical instrument (of any kind)
ᎧᏃᏅ	Other	ᎧᏃᏅ:Pounding block
ᎧᏃᏍᎬ	Other	ᎧᏃᏍᎬ:Coal
ᎧᏄᎦ	Immediate	ᎠᎧᏂ:Returning an animal
ᎧᏄᎦᎵ	Other	ᎧᏄᎦᎵ:Briar
ᎧᏄᎾ	Immediate	ᏓᎧᏁᎦ:Placing living things in a row
ᎧᏄᏄ	Other	ᎧᏄᏄ:Genus: Kana Catesbetana
ᎧᏅᎢ	RemotePast	ᎦᎧᎲᏍᎦ:Setting up
ᎧᏅᎦ	Immediate	ᎤᎧᎾᎠ:Has livestock or animals
ᎧᏅᏍᏗ	Deverbal	ᎠᎧᏂ:Returning an animal
ᎧᏅᏗ	Deverbal	ᎤᎧᎾᎠ:Has livestock or animals
ᎧᏅᏥ	Other	ᎧᏅᏥ:Hickory nut soup
ᎧᏅᏧᏩ	Other	ᎧᏅᏧᏩ:Genus: Panoion Haliaetus
ᎧᏆᎸᏂᎭ	PresentContinous	ᎠᎧᏆᎸᏂᎭ:Slapping it
ᎧᏆᎸᏂᎰᎢ	Habitual	ᎠᎧᏆᎸᏂᎭ:Slapping it
ᎧᏆᎸᏂᎸᎢ	RemotePast	ᎠᎧᏆᎸᏂᎭ:Slapping it
ᎧᏆᎸᏂᏍᏗ	Deverbal	ᎠᎧᏆᎸᏂᎭ:Slapping it
ᎧᏆᎸᏣ	Immediate	ᎠᎧᏆᎸᏂᎭ:Slapping it
ᎧᏩᏯ	Other	ᎧᏩᏯ:Huckleberry
ᎧᏬᎬ	Other	ᎧᏬᎬ:Wood thrush
ᎧᏬᏄ	Other	ᎧᏬᏄ:April
ᎧᏲᎭ	Immediate	ᎠᎧᏲᏍᎦ:Drying out
ᎧᏲᎯᏍᏗ	Deverbal	ᎠᎧᏲᏍᎦ:Drying out
ᎧᏲᏍᎦ	PresentContinous	ᎠᎧᏲᏍᎦ:Drying out
ᎧᏲᏍᎪᎢ	Habitual	ᎠᎧᏲᏍᎦ:Drying out
ᎧᏲᏒᎢ	RemotePast	ᎠᎧᏲᏍᎦ:Drying out
ᎧᏲᏓ	Immediate	ᎠᎧᏲᏗᎭ:Drying it
ᎧᏲᏔᏅᎢ	RemotePast	ᎠᎧᏲᏗᎭ:Drying it
ᎧᏲᏗᎭ	PresentContinous	ᎠᎧᏲᏗᎭ:Drying it
ᎧᏲᏗᏍᎪᎢ	Habitual	ᎠᎧᏲᏗᎭ:Drying it
ᎧᏲᏙᏗ	Deverbal	ᎠᎧᏲᏗᎭ:Drying it
ᎨᎮᏒᎢ	RemotePast	ᎠᎨᎯ:Chasing
ᎨᎯ	PresentContinous	ᎠᎨᎯ:Chasing
ᎨᎱᎦ	Immediate	ᎠᎨᎯ:Chasing
ᎨᎲᏍᏗ	Deverbal	ᎠᎨᎯ:Chasing
ᎨᎳᏗ	Other	ᎨᎳᏗ:Possum grapes
ᎨᎵᏥᎩ	Other	ᎨᎵᏥᎩ:Pie
ᎨᎻᎵ	Other	ᎨᎻᎵ:Camel (Enligh Borrowing)
ᎨᏉᎬ	Other	ᎨᏉᎬ:Pileated woodpecker
ᎨᏍᏗ	Other	ᎨᏍᏗ:Not
ᎨᏐᎢ	Habitual	ᎠᎨᎯ:Chasing
ᎨᏓᎵ	Other	ᎨᏓᎵ:Downhill
ᎨᏬᎢᏍᏗ	Deverbal	ᏓᎨᏬᎦ:Blind (becoming)
ᎨᏬᎦ	Immediate	ᏓᎨᏬᎦ:Blind (becoming)
ᎨᏬᎪᎢ	Habitual	ᏓᎨᏬᎦ:Blind (becoming)
ᎨᏬᏨᎢ	RemotePast	ᏓᎨᏬᎦ:Blind (becoming)
ᎨᏯ	PresentContinous	ᎠᎨᏯ:Flowing
ᎨᏯᏓ	Immediate	ᎠᎨᏯᏗᎭ:Refusing to give him
ᎨᏯᏔᎯ	Other	ᎨᏯᏔᎯ:Wild (not tame)
ᎨᏯᏔᏅᎢ	RemotePast	ᎠᎨᏯᏗᎭ:Refusing to give him
ᎨᏯᏗᎭ	PresentContinous	ᎠᎨᏯᏗᎭ:Refusing to give him
ᎨᏯᏗᏍᎪᎢ	Habitual	ᎠᎨᏯᏗᎭ:Refusing to give him
ᎨᏯᏙᏗ	Deverbal	ᎠᎨᏯᏗᎭ:Refusing to give him
ᎨᏲᎢ	Habitual	ᎠᎨᏯ:Flowing
ᎨᏴᏍᏗ	Deverbal	ᎠᎨᏯ:Flowing
ᎨᏴᏒᎢ	RemotePast	ᎠᎨᏯ:Flowing
ᎩᎠ	Immediate	ᎠᎩᎡᎭ:Taking something solid from him	ᎠᎩᎠ:Eating something solid
ᎩᎡᎭ	PresentContinous	ᎠᎩᎡᎭ:Taking something solid from him
ᎩᎡᎰᎢ	Habitual	ᎠᎩᎡᎭ:Taking something solid from him
ᎩᎡᎸᎢ	RemotePast	ᎠᎩᎡᎭ:Taking something solid from him
ᎩᎡᏗ	Deverbal	ᎠᎩᎡᎭ:Taking something solid from him
ᎩᎦ	Other	ᎩᎦ:Blood
ᎩᎦᎨᎢ	Other	ᎩᎦᎨᎢ:Red (color)
ᎩᎦᎨᏨᏩᎩ	Other	ᎩᎦᎨᏨᏩᎩ:Red maple
ᎩᎩ	Other	ᎩᎩ:Sparrow hawk
ᎩᎭ	Immediate	ᎠᎩᏍᎦ:Swallowing
ᎩᎯᏍᏗ	Deverbal	ᎠᎩᏍᎦ:Swallowing
ᎩᎵ	Other	ᎩᎵ:Genus: Canis Failiaris
ᎩᎵᎦ	Immediate	ᎠᎩᎵᎩᎠ:Removing an animal from rsur
ᎩᎵᎩᎠ	PresentContinous	ᎠᎩᎵᎩᎠ:Removing an animal from rsur
ᎩᎵᎩᏍᎪᎢ	Habitual	ᎠᎩᎵᎩᎠ:Removing an animal from rsur
ᎩᎵᎩᏍᏗ	Deverbal	ᎠᎩᎵᎩᎠ:Removing an animal from rsur
ᎩᎵᎩᏒᎢ	RemotePast	ᎠᎩᎵᎩᎠ:Removing an animal from rsur
ᎩᎵᏲᎢᏍᏗ	Deverbal	ᎠᎩᎵᏲᎦ:Suffering
ᎩᎵᏲᎦ	Immediate	ᎠᎩᎵᏲᎦ:Suffering
ᎩᎵᏲᎪᎢ	Habitual	ᎠᎩᎵᏲᎦ:Suffering
ᎩᎵᏲᏨᎢ	RemotePast	ᎠᎩᎵᏲᎦ:Suffering
ᎩᎶᎢ	Other	ᎩᎶᎢ:Someone
ᎩᏌ	Immediate	ᎦᎩᏍᎭ:Gathering things
ᎩᏍᎦ	PresentContinous	ᎠᎩᏍᎦ:Swallowing
ᎩᏍᎪᎢ	Habitual	ᎠᎩᏍᎦ:Swallowing	ᎠᎩᎠ:Picking up something solid
ᎩᏍᎭ	PresentContinous	ᎦᎩᏍᎭ:Gathering things
ᎩᏍᏅᎢ	RemotePast	ᎦᎩᏍᎭ:Gathering things
ᎩᏍᏗ	Deverbal	ᎠᎩᎠ:Picking up something solid
ᎩᏍᏙᎠ	PresentContinous	ᎠᎩᏍᏙᎠ:Chewing
ᎩᏍᏙᎥᎢ	RemotePast	ᎠᎩᏍᏙᎠ:Chewing
ᎩᏍᏙᏍᎪᎢ	Habitual	ᎠᎩᏍᏙᎠ:Chewing
ᎩᏍᏙᏍᏗ	Deverbal	ᎠᎩᏍᏙᎠ:Chewing
ᎩᏍᏙᏣ	Immediate	ᎠᎩᏍᏙᎠ:Chewing
ᎩᏎᎪᎢ	Habitual	ᎠᎩᏏ:Fetching something solid
ᎩᏎᏒᎢ	RemotePast	ᎠᎩᏏ:Fetching something solid
ᎩᏏ	PresentContinous	ᎠᎩᏏ:Fetching something solid
ᎩᏏᏍᎪᎢ	Habitual	ᎦᎩᏍᎭ:Gathering things
ᎩᏐᏗ	Deverbal	ᎦᎩᏍᎭ:Gathering things
ᎩᏑᎦ	Immediate	ᎠᎩᏏ:Fetching something solid
ᎩᏒᎢ	RemotePast	ᎠᎩᏍᎦ:Swallowing	ᎠᎩᎠ:Picking up something solid
ᎩᏒᏍᏗ	Deverbal	ᎠᎩᏏ:Fetching something solid
ᎩᏳᎦ	Other	ᎩᏳᎦ:Ground squirrel
ᎩᏳᎬ	Other	ᎩᏳᎬ:Worm-eating warbler
ᎪᎢ	Other	ᎪᎢ:Ground snake
ᎪᎦ	Other	ᎪᎦ:Genus: Corvus Brachyrhynchus
ᎪᎦᏍᏗ	Other	ᎪᎦᏍᏗ:Cigarette
ᎪᎩ	Other	ᎪᎩ:Summer (1st new moon in April to the 1st new moon in October)
ᎪᎯ	Other	ᎪᎯ:Genus: Juglan Cinerea
ᎪᎯᎩᎳ	Other	ᎪᎯᎩᎳ:After a while
ᎪᎯᏳ	Other	ᎪᎯᏳ:Later
ᎪᎲᏓᏓᎳ	Other	ᎪᎲᏓᏓᎳ:Knoxville, TN
ᎪᎳ	Other	ᎪᎳ:Winter (1st new moon in October to the 1st new moon in April)
ᎪᎳᎧᎩᏍᏗ	Other	ᎪᎳᎧᎩᏍᏗ:Genus: Eupetorium Sp
ᎪᎵᏍᏓᏴᎢ	Other	ᎪᎵᏍᏓᏴᎢ:Water that is moving swiftly
ᎪᎵᏯ	Immediate	ᎠᎪᎵᏰᎠ:Studying
ᎪᎵᏰᎠ	PresentContinous	ᎠᎪᎵᏰᎠ:Studying
ᎪᎵᏰᎥᎢ	RemotePast	ᎠᎪᎵᏰᎠ:Studying
ᎪᎵᏰᏍᎪᎢ	Habitual	ᎠᎪᎵᏰᎠ:Studying
ᎪᎵᏰᏗ	Deverbal	ᎠᎪᎵᏰᎠ:Studying
ᎪᎸᎠ	PresentContinous	ᎠᎪᎸᎠ:Turning it around
ᎪᎸᎲ	Other	ᎪᎸᎲ:Boney
ᎪᎸᎾ	Immediate	ᎠᎪᎸᎠ:Turning it around
ᎪᎸᏅ	Other	ᎪᎸᏅ:Raven
ᎪᎸᏅᏱ	Other	ᎪᎸᏅᏱ:Raven's Place (Big Cove)
ᎪᎸᏍᎪᎢ	Habitual	ᎠᎪᎸᎠ:Turning it around
ᎪᎸᏍᏗ	Deverbal	ᎠᎪᎸᎠ:Turning it around
ᎪᎸᏒᎢ	RemotePast	ᎠᎪᎸᎠ:Turning it around
ᎪᏂᏲᎢᏍᏗ	Deverbal	ᎤᎪᏂᏲᎦ:Late
ᎪᏂᏲᎦ	PresentContinous	ᎤᎪᏂᏲᎦ:Late
ᎪᏂᏲᎨᏍᏔ	Immediate	ᎤᎪᏂᏲᎦ:Late
ᎪᏂᏲᎨᏍᏗ	Deverbal	ᎤᎪᏂᏲᎦ:Late
ᎪᏂᏲᎨᏍᏛᎢ	RemotePast	ᎤᎪᏂᏲᎦ:Late
ᎪᏂᏲᎪᎢ	Habitual	ᎤᎪᏂᏲᎦ:Late
ᎪᏂᏲᏨᎢ	RemotePast	ᎤᎪᏂᏲᎦ:Late
ᎪᏍᎩᏍᏓᏅᎢ	RemotePast	ᎠᎪᏍᎩᏍᏗᎭ:Elbowing
ᎪᏍᎩᏍᏗᎭ	PresentContinous	ᎠᎪᏍᎩᏍᏗᎭ:Elbowing
ᎪᏍᎩᏍᏗᏍᎪᎢ	Habitual	ᎠᎪᏍᎩᏍᏗᎭ:Elbowing
ᎪᏍᎩᏗ	Deverbal	ᎠᎪᏍᎩᏍᏗᎭ:Elbowing
ᎪᏍᏓ	Other	ᎪᏍᏓ:Ashes
ᎪᏍᏓᏂᏍᏗ	Other	ᎪᏍᏓᏂᏍᏗ:Plantain (narrow leaved variety)
ᎪᏍᏗᏳᎵ	Other	ᎪᏍᏗᏳᎵ:Blunt
ᎪᏍᏗᏳᏍᏗ	Other	ᎪᏍᏗᏳᏍᏗ:Rabbit tobacco
ᎪᏍᏙᎯ	Other	ᎪᏍᏙᎯ:Ashes (in)
ᎪᏒᎦ	Other	ᎪᏒᎦ:Genus: Sambucus Canadensis
ᎪᏒᎾᎳᏗᏍᏗᏳ	Other	ᎪᏒᎾᎳᏗᏍᏗᏳ:Window lock
ᎪᏒᏅ	Other	ᎪᏒᏅ:Margarine
ᎪᏕᏍᎩ	Other	ᎪᏕᏍᎩ:Spade
ᎪᏗ	Deverbal	ᎤᎧᎭ:Has something alive
ᎪᏛᎤᏅᎢ	RemotePast	ᎠᎪᏛᎥᏍᎦ:Sprinkling
ᎪᏛᎥᎦ	Immediate	ᎠᎪᏛᎥᏍᎦ:Sprinkling
ᎪᏛᎥᏍᎦ	PresentContinous	ᎠᎪᏛᎥᏍᎦ:Sprinkling
ᎪᏛᎥᏍᎪᎢ	Habitual	ᎠᎪᏛᎥᏍᎦ:Sprinkling
ᎪᏛᏗ	Deverbal	ᎠᎪᏛᎥᏍᎦ:Sprinkling
ᎪᏩᏔ	Immediate	ᎠᎪᏩᏘᎭ:Seeing
ᎪᏩᏘᎭ	PresentContinous	ᎠᎪᏩᏘᎭ:Seeing
ᎪᏩᏘᏍᎪᎢ	Habitual	ᎠᎪᏩᏘᎭ:Seeing
ᎪᏩᏛᎲᎢ	RemotePast	ᎠᎪᏩᏘᎭ:Seeing
ᎪᏩᏛᏗ	Deverbal	ᎠᎪᏩᏘᎭ:Seeing
ᎪᏪᎵ	Other	ᎪᏪᎵ:Paper
ᎪᏪᎵᏗᎦᏂᏙᎯ	Other	ᎪᏪᎵᏗᎦᏂᏙᎯ:Mailman
ᎪᏫ	Other	ᎪᏫ:Coffee (English Borrowing)
ᎪᏯᏛᎢ	Other	ᎪᏯᏛᎢ:Sleeve
ᎫᎠ	Immediate	ᎤᎫᎴᎦ:Belching (1)
ᎫᎦ	Immediate	ᎠᎫᎩᎠ:Dipping something liquid
ᎫᎩᎠ	PresentContinous	ᎠᎫᎩᎠ:Dipping something liquid
ᎫᎩᏍᎪᎢ	Habitual	ᎠᎫᎩᎠ:Removing something liquid from a container
ᎫᎩᏍᏗ	Deverbal	ᎠᎫᎩᎠ:Dipping something liquid
ᎫᎩᏒᎢ	RemotePast	ᎠᎫᎩᎠ:Taking liquid from liquid
ᎫᎫ	Other	ᎫᎫ:Vial
ᎫᎴ	Other	ᎫᎴ:Acorn
ᎫᎴᎠ	PresentContinous	ᎤᎫᎴᎠ:Belching (2)
ᎫᎴᎥᎢ	RemotePast	ᎤᎫᎴᎦ:Belching (1)
ᎫᎴᎦ	PresentContinous	ᎤᎫᎴᎦ:Belching (1)	ᎤᎫᎴᎠ:Belching (2)
ᎫᎴᎪᎢ	Habitual	ᎤᎫᎴᎦ:Belching (1)
ᎫᎴᏍᎪᎢ	Habitual	ᎤᎫᎴᎠ:Belching (2)
ᎫᎴᏗ	Deverbal	ᎤᎫᎴᎦ:Belching (1)	ᎤᎫᎴᎠ:Belching (2)
ᎫᎴᏗᏍᎪᏂᎯ	Other	ᎫᎴᏗᏍᎪᏂᎯ:Turtle dove
ᎫᎴᏧᎾᏍᏗ	Other	ᎫᎴᏧᎾᏍᏗ:Red oak
ᎫᎴᏨᎢ	RemotePast	ᎤᎫᎴᎠ:Belching (2)
ᎫᏍᎩᎠ	PresentContinous	ᎠᎫᏍᎩᎠ:Nudging with his elbow
ᎫᏍᎩᏍᎪᎢ	Habitual	ᎠᎫᏍᎩᎠ:Nudging with his elbow
ᎫᏍᎩᏍᏓ	Immediate	ᎠᎫᏍᎩᎠ:Nudging with his elbow
ᎫᏍᎩᏔᏅᎢ	RemotePast	ᎠᎫᏍᎩᎠ:Nudging with his elbow
ᎫᏍᎪᏗ	Deverbal	ᎠᎫᏍᎩᎠ:Nudging with his elbow
ᎫᏍᏆᎶᎠ	PresentContinous	ᎤᎫᏍᏆᎶᎠ:Bumping his elbow
ᎫᏍᏆᎶᎥᎢ	RemotePast	ᎤᎫᏍᏆᎶᎠ:Bumping his elbow
ᎫᏍᏆᎶᏍᎪᎢ	Habitual	ᎤᎫᏍᏆᎶᎠ:Bumping his elbow
ᎫᏍᏆᎶᏍᏗ	Deverbal	ᎤᎫᏍᏆᎶᎠ:Bumping his elbow
ᎫᏍᏆᎶᏣ	Immediate	ᎤᎫᏍᏆᎶᎠ:Bumping his elbow
ᎫᏍᏗ	Other	ᎫᏍᏗ:Genus: Fagus L
ᎫᏩ	Other	ᎫᏩ:Mulberry
ᎫᏫᏳᎦᏍᏗ	Other	ᎫᏫᏳᎦᏍᏗ:Sycamore
ᎫᏰᏉᏂ	Other	ᎫᏰᏉᏂ:July
ᎬᎠ	PresentContinous	ᎠᎬᎠ:Moving something alive or something solid
ᎬᎢ	RemotePast	ᎠᎩᎠ:Eating something solid
ᎬᎢᏍᏗ	Deverbal	ᎠᎬᎦ:Drowning
ᎬᎥᎢ	RemotePast	ᎠᎬᎠ:Moving something alive or something solid
ᎬᎦ	Immediate	ᎠᎬᎦ:Drowning
ᎬᎩᏍᏗ	Other	ᎬᎩᏍᏗ:Watermelon
ᎬᎪᎢ	Habitual	ᎠᎬᎦ:Drowning
ᎬᎪᏍᏗ	Other	ᎬᎪᏍᏗ:Sifter
ᎬᎭᎳ	Immediate	ᎠᎬᎭᎵᎭ:Cutting off something solid
ᎬᎭᎳᏗ	Deverbal	ᎠᎬᎭᎵᎭ:Cutting off something solid
ᎬᎭᎵᎭ	PresentContinous	ᎠᎬᎭᎵᎭ:Cutting off something solid
ᎬᎭᎵᏍᎪᎢ	Habitual	ᎠᎬᎭᎵᎭ:Cutting off something solid
ᎬᎭᎸᎲᎢ	RemotePast	ᎠᎬᎭᎵᎭ:Cutting off something solid
ᎬᎮ	Other	ᎬᎮ:Genus: Lynx Rufus
ᎬᎲᎵ	Other	ᎬᎲᎵ:Raccoon
ᎬᎾ	Other	ᎬᎾ:Turkey	ᎠᎬᎠ:Moving something alive or something solid
ᎬᏁᎯ	Other	ᎬᏁᎯ:Ink pen
ᎬᏂᎨᎢ	Other	ᎬᏂᎨᎢ:Black
ᎬᏂᎵᏓᏍᏙᏗ	Other	ᎬᏂᎵᏓᏍᏙᏗ:Hammer
ᎬᏃᏌᏍᏗ	Other	ᎬᏃᏌᏍᏗ:Broom
ᎬᏅᎩᎵᎩ	Other	ᎬᏅᎩᎵᎩ:Honeysuckle bush
ᎬᏅᏛᎩ	Other	ᎬᏅᏛᎩ:Kentucky
ᎬᏍᎪᎢ	Habitual	ᎠᎬᎠ:Moving something alive or something solid
ᎬᏍᏗ	Deverbal	ᎠᎬᎠ:Moving something alive or something solid
ᎬᏓ	Other	ᎬᏓ:Fire (in a)
ᎬᏓᎳᎦ	Immediate	ᏓᎬᏓᎳᎩᎠ:Pulling rocks from the ground
ᎬᏓᎳᎩᎠ	PresentContinous	ᏓᎬᏓᎳᎩᎠ:Pulling rocks from the ground
ᎬᏓᎳᎩᏍᎪᎢ	Habitual	ᏓᎬᏓᎳᎩᎠ:Pulling rocks from the ground
ᎬᏓᎳᎩᏍᏗ	Deverbal	ᏓᎬᏓᎳᎩᎠ:Pulling rocks from the ground
ᎬᏓᎳᎩᏒᎢ	RemotePast	ᏓᎬᏓᎳᎩᎠ:Pulling rocks from the ground
ᎬᏗ	Other	ᎬᏗ:With
ᎬᏨᎢ	RemotePast	ᎠᎬᎦ:Drowning
ᎬᏩᎳᎦ	Immediate	ᏓᎬᏩᎳᏍᎦ:Betting
ᎬᏩᎳᏅᎢ	RemotePast	ᏓᎬᏩᎳᏍᎦ:Betting
ᎬᏩᎳᏍᎦ	PresentContinous	ᏓᎬᏩᎳᏍᎦ:Betting
ᎬᏩᎳᏍᎪᎢ	Habitual	ᏓᎬᏩᎳᏍᎦ:Betting
ᎬᏩᎳᏗ	Deverbal	ᏓᎬᏩᎳᏍᎦ:Betting
ᎬᏯ	Immediate	ᎠᎬᏯᏍᎦ:Drowning him
ᎬᏯᎲᎢ	RemotePast	ᎠᎬᏯᏍᎦ:Drowning him
ᎬᏯᏍᎦ	PresentContinous	ᎠᎬᏯᏍᎦ:Drowning him
ᎬᏯᏍᎪᎢ	Habitual	ᎠᎬᏯᏍᎦ:Drowning him
ᎬᏯᏍᏗ	Deverbal	ᎠᎬᏯᏍᎦ:Drowning him
Ꭽ	PresentContinous	ᎤᎭ:Has something solid
ᎭᎾ	Other	ᎭᎾ:There
ᎭᏂ	Other	ᎭᏂ:Here, this
ᎭᏃ	Other	ᎭᏃ:Never
ᎭᏔᎦ	Immediate	ᎠᎭᏔᏍᎦ:Hammering in
ᎭᏔᏅᎢ	RemotePast	ᎠᎭᏔᏍᎦ:Hammering in
ᎭᏔᏍᎦ	PresentContinous	ᎠᎭᏔᏍᎦ:Hammering in
ᎭᏔᏍᎪᎢ	Habitual	ᎠᎭᏔᏍᎦ:Hammering in
ᎭᏗ	Other	ᎭᏗ:No
ᎭᏘ	Deverbal	ᎠᎭᏔᏍᎦ:Hammering in
ᎭᏢ	Other	ᎭᏢ:Where? (Oklahoma Dialect)
ᎭᏦᏩᏛ	Other	ᎭᏦᏩᏛ:Pocket
ᎭᏩ	Other	ᎭᏩ:Okay
ᎭᏩᎦ	Other	ᎭᏩᎦ:Isn't that right?
ᎭᏩᏉ	Other	ᎭᏩᏉ:So long for now (idiom)
ᎭᏫᏂ	Other	ᎭᏫᏂ:Inside
ᎭᏫᏯ	Other	ᎭᏫᏯ:Meat
ᎭᏯᎦᎸᏛᎢ	Other	ᎭᏯᎦᎸᏛᎢ:Wall paper
ᎭᏯᏦᎯ	Other	ᎭᏯᏦᎯ:Handkerchief
ᎭᏰᎳᏍᏗ	Other	ᎭᏰᎳᏍᏗ:Knife
ᎮᎦᎳ	Immediate	ᎦᎮᎦᎵᎭ:Skinning it
ᎮᎦᎵᎭ	PresentContinous	ᎦᎮᎦᎵᎭ:Skinning it
ᎮᎦᎵᏍᎪᎢ	Habitual	ᎦᎮᎦᎵᎭ:Skinning it
ᎮᎦᎵᏗ	Deverbal	ᎦᎮᎦᎵᎭ:Skinning it
ᎮᎦᎸᎲᎢ	RemotePast	ᎦᎮᎦᎵᎭ:Skinning it
ᎮᎲᎦ	Immediate	ᎦᎮᎲᏍᎦ:Laying down something liquid
ᎮᎲᏍᎦ	PresentContinous	ᎦᎮᎲᏍᎦ:Laying down something liquid
ᎮᎲᏍᎪᎢ	Habitual	ᎦᎮᎲᏍᎦ:Laying down something liquid
ᎮᏅᎢ	RemotePast	ᎦᎮᎲᏍᎦ:Laying down something liquid
ᎮᏍᏔ	Immediate	ᎤᎭ:Has something solid
ᎮᏍᏗ	Deverbal	ᎤᎭ:Has something solid
ᎮᏍᏛᎢ	RemotePast	ᎤᎭ:Has something solid
ᎮᏗ	Deverbal	ᎦᎮᎲᏍᎦ:Laying down something liquid
ᎯᎠ	Other	ᎯᎠ:This one
ᎯᎠᏃᏄᏍᏗ	Other	ᎯᎠᏃᏄᏍᏗ:This is
ᎯᎢᏨ	Other	ᎯᎢᏨ:This way
ᎯᎦ	Other	ᎯᎦ:This much
ᎯᎩᏍᎪᎯ	Other	ᎯᎩᏍᎪᎯ:Fifty
ᎯᎭ	PresentContinous	ᎠᎯᎭ:Killing
ᎯᎰᎢ	Habitual	ᎠᎯᎭ:Killing
ᎯᎵᏍᏛᏬᏨ	Other	ᎯᎵᏍᏛᏬᏨ:Pull (corn fodder or blades)
ᎯᎵᏲᎢᏍᏗ	Deverbal	ᎠᎯᎵᏲᎦ:Agony, suffering (in)
ᎯᎵᏲᎦ	Immediate	ᎠᎯᎵᏲᎦ:Agony, suffering (in)
ᎯᎵᏲᎪᎢ	Habitual	ᎠᎯᎵᏲᎦ:Agony, suffering (in)
ᎯᎵᏲᏨᎢ	RemotePast	ᎠᎯᎵᏲᎦ:Agony, suffering (in)
ᎯᏍᎦᏚᎯ	Other	ᎯᏍᎦᏚᎯ:Fifteen
ᎯᏍᎩ	Other	ᎯᏍᎩ:Five
ᎯᏍᏉ	Other	ᎯᏍᏉ:Him too
ᎯᏍᏗ	Deverbal	ᎠᎯᎭ:Killing
ᎯᏯ	Immediate	ᎠᎯᏱᎠ:Leaving something solid or something liquid
ᎯᏱᎠ	PresentContinous	ᎠᎯᏱᎠ:Leaving something solid or something liquid
ᎯᏱᎥᎢ	RemotePast	ᎠᎯᏱᎠ:Leaving something solid or something liquid
ᎯᏱᏍᎪᎢ	Habitual	ᎠᎯᏱᎠ:Leaving something solid or something liquid
ᎯᏱᏍᏗ	Deverbal	ᎠᎯᏱᎠ:Leaving something solid or something liquid
ᎰᎢ	Habitual	ᎤᎭ:Has something solid
ᎰᏫᏂ	Other	ᎰᏫᏂ:Inside
ᎰᏫᏂᏣ	Other	ᎰᏫᏂᏣ:Under
ᎱᎱ	Other	ᎱᎱ:Yellow breasted mockingbird
ᎱᎳᎨᎠ	Immediate	ᎠᎱᎳᎨᎦ:Homesick
ᎱᎳᎨᎦ	PresentContinous	ᎠᎱᎳᎨᎦ:Homesick
ᎱᎳᎨᎪᎢ	Habitual	ᎠᎱᎳᎨᎦ:Homesick
ᎱᎳᎨᏍᏗ	Deverbal	ᎠᎱᎳᎨᎦ:Homesick
ᎱᎳᎨᏨᎢ	RemotePast	ᎠᎱᎳᎨᎦ:Homesick
ᎱᎴᏴᎭ	Immediate	ᎠᎱᎴᏴᏍᎦ:Burning himself with hot food
ᎱᎴᏴᎯᏍᏗ	Deverbal	ᎠᎱᎴᏴᏍᎦ:Burning himself with hot food
ᎱᎴᏴᏍᎦ	PresentContinous	ᎠᎱᎴᏴᏍᎦ:Burning himself with hot food
ᎱᎴᏴᏍᎪᎢ	Habitual	ᎠᎱᎴᏴᏍᎦ:Burning himself with hot food
ᎱᎴᏴᏒᎢ	RemotePast	ᎠᎱᎴᏴᏍᎦ:Burning himself with hot food
ᎱᎵᏏᎬᎢ	Other	ᎱᎵᏏᎬᎢ:Dark (in the)
ᎱᎾᏓᏥᎬ	Other	ᎱᎾᏓᏥᎬ:Group
ᎱᏂᎯᎥ	Other	ᎱᏂᎯᎥ:Stream
ᎱᏓ	Other	ᎱᏓ:Vine, to be on	ᎠᎱᏗᎠ:Putting something long into something liquid
ᎱᏗᎠ	PresentContinous	ᎠᎱᏗᎠ:Putting something long into something liquid
ᎱᏗᏍᎪᎢ	Habitual	ᎠᎱᏗᎠ:Putting something long into something liquid
ᎱᏗᏍᏗ	Deverbal	ᎠᎱᏗᎠ:Putting something long into something liquid
ᎱᏛᎢ	RemotePast	ᎠᎱᏗᎠ:Putting something long into something liquid
ᎱᏱᎤᏌ	Immediate	ᎠᎱᏱᏏᎭ:Taking something long from something liquid
ᎱᏱᏏᎭ	PresentContinous	ᎠᎱᏱᏏᎭ:Taking something long from something liquid
ᎱᏱᏏᏍᎪᎢ	Habitual	ᎠᎱᏱᏏᎭ:Taking something long from something liquid
ᎱᏱᏒᎲᎢ	RemotePast	ᎠᎱᏱᏏᎭ:Taking something long from something liquid
ᎱᏱᏒᏗ	Deverbal	ᎠᎱᏱᏏᎭ:Taking something long from something liquid
ᎱᏳᎩ	Other	ᎱᏳᎩ:Disease
ᎲᎦ	Other	ᎲᎦ:How	ᎠᎲᏍᎦ:Laying down something solid
ᎲᎦᎢᏴ	Other	ᎲᎦᎢᏴ:When
ᎲᏍᎦ	PresentContinous	ᎠᎲᏍᎦ:Laying down something solid
ᎲᏍᎪᎢ	Habitual	ᎠᎲᏍᎦ:Laying down something solid
ᎲᏓᎦ	Immediate	ᎠᎲᏓᎩᎠ:Taking something long off a fire
ᎲᏓᎩᎠ	PresentContinous	ᎠᎲᏓᎩᎠ:Taking something long off a fire
ᎲᏓᎩᏍᎪᎢ	Habitual	ᎠᎲᏓᎩᎠ:Taking something long off a fire
ᎲᏓᎩᏍᏗ	Deverbal	ᎠᎲᏓᎩᎠ:Taking something long off a fire
ᎲᏓᎩᏒᎢ	RemotePast	ᎠᎲᏓᎩᎠ:Taking something long off a fire
ᎲᏔᎦ	Immediate	ᎠᎲᏔᏍᎦ:Putting something long into a fire
ᎲᏔᏍᎦ	PresentContinous	ᎠᎲᏔᏍᎦ:Putting something long into a fire
ᎲᏔᏍᎪᎢ	Habitual	ᎠᎲᏔᏍᎦ:Putting something long into a fire
ᎲᏔᏗ	Deverbal	ᎠᎲᏔᏍᎦ:Putting something long into a fire
ᎲᏛᏅᎢ	RemotePast	ᎠᎲᏔᏍᎦ:Putting something long into a fire
Ꮃ	PresentContinous	ᎦᎳ:Container (something long) (in a)
ᎳᎠ	PresentContinous	ᎦᎳᎠ:Container (something solid) (in a)
ᎳᎡᏍᏔ	Immediate	ᎦᎳᎠ:Container (something flexible) (in a)
ᎳᎡᏍᏗ	Deverbal	ᎦᎳᎠ:Container (something flexible) (in a)
ᎳᎡᏍᏛᎢ	RemotePast	ᎦᎳᎠ:Container (something solid) (in a)
ᎳᎢᏗ	Deverbal	ᎦᎳᎠ:Container (something solid) (in a)
ᎳᎣᎢ	Habitual	ᎦᎳᎠ:Container (something flexible) (in a)
ᎳᎦ	Immediate	ᎦᎳᏍᎦ:Putting something solid into a container	ᎦᎳᎩᎠ:Removing something long or something liquid from a container
ᎳᎨᏴᏛᎥᎦ	Immediate	ᎦᎳᎨᏴᏛᎥᏍᎦ:Scattering
ᎳᎨᏴᏛᎥᏍᎦ	PresentContinous	ᎦᎳᎨᏴᏛᎥᏍᎦ:Scattering
ᎳᎨᏴᏛᎥᏍᎪᎢ	Habitual	ᎦᎳᎨᏴᏛᎥᏍᎦ:Scattering
ᎳᎨᏴᏛᏅᎢ	RemotePast	ᎦᎳᎨᏴᏛᎥᏍᎦ:Scattering
ᎳᎨᏴᏛᏗ	Deverbal	ᎦᎳᎨᏴᏛᎥᏍᎦ:Scattering
ᎳᎩᎠ	PresentContinous	ᎦᎳᎩᎠ:Removing something solid from a container
ᎳᎩᏍᎪᎢ	Habitual	ᎦᎳᎩᎠ:Removing something solid from a container
ᎳᎩᏍᏗ	Deverbal	ᎦᎳᎩᎠ:Removing something long or something liquid from a container
ᎳᎩᏒᎢ	RemotePast	ᎦᎳᎩᎠ:Removing something long or something liquid from a container
ᎳᎪᎰᎭ	Immediate	ᎦᎳᎪᎰᏍᎦ:Leaves are turning
ᎳᎪᎰᏍᎦ	PresentContinous	ᎦᎳᎪᎰᏍᎦ:Leaves are turning
ᎳᎪᎰᏍᎪᎢ	Habitual	ᎦᎳᎪᎰᏍᎦ:Leaves are turning
ᎳᎪᎰᏍᏗ	Deverbal	ᎦᎳᎪᎰᏍᎦ:Leaves are turning
ᎳᎪᎰᏒᎢ	RemotePast	ᎦᎳᎪᎰᏍᎦ:Leaves are turning
ᎳᎮᏒᎢ	RemotePast	ᎦᎳᎯ:Climbing (up)
ᎳᎯ	PresentContinous	ᎦᎳᎯ:Climbing (up)
ᎳᎯᏐᎢ	Habitual	ᎦᎳᎯ:Climbing (up)
ᎳᎱᎦ	Immediate	ᎦᎳᎯ:Climbing (up)
ᎳᎲᏍᏗ	Deverbal	ᎦᎳᎯ:Climbing (up)
ᎳᏅᎢ	RemotePast	ᎦᎳᏍᎦ:Putting something solid into a container
ᎳᏍᎦ	PresentContinous	ᎦᎳᏍᎦ:Putting something solid into a container
ᎳᏍᎪᎢ	Habitual	ᎦᎳᏍᎦ:Putting something solid into a container
ᎳᏍᏚᏬᎠ	PresentContinous	ᎠᎳᏍᏚᏬᎠ:Pulling corn slades off
ᎳᏍᏚᏬᎥᎢ	RemotePast	ᎠᎳᏍᏚᏬᎠ:Pulling corn slades off
ᎳᏍᏚᏬᏍᎪᎢ	Habitual	ᎠᎳᏍᏚᏬᎠ:Pulling corn slades off
ᎳᏍᏚᏬᏍᏗ	Deverbal	ᎠᎳᏍᏚᏬᎠ:Pulling corn slades off
ᎳᏍᏚᏬᏣ	Immediate	ᎠᎳᏍᏚᏬᎠ:Pulling corn slades off
ᎳᏐᏰᎭ	PresentContinous	ᎦᎳᏐᏰᎭ:Shaking it off of a tree
ᎳᏐᏰᎲᎢ	RemotePast	ᎦᎳᏐᏰᎭ:Shaking it off of a tree
ᎳᏐᏰᏍᎪᎢ	Habitual	ᎦᎳᏐᏰᎭ:Shaking it off of a tree
ᎳᏐᏰᏗ	Deverbal	ᎦᎳᏐᏰᎭ:Shaking it off of a tree
ᎳᏓ	Immediate	ᎦᎳᏗᎠ:Putting something long into a container
ᎳᏗ	Deverbal	ᎦᎳᏍᎦ:Putting something solid into a container
ᎳᏗᎠ	PresentContinous	ᎦᎳᏗᎠ:Putting something long into a container
ᎳᏗᏍᎪᎢ	Habitual	ᎦᎳᏗᎠ:Putting something long into a container
ᎳᏗᏍᏗ	Deverbal	ᎦᎳᏗᎠ:Putting something long into a container
ᎳᏛᎢ	RemotePast	ᎦᎳᏗᎠ:Putting something long into a container
ᎴᏍᏔ	Immediate	ᎦᎳ:Container (something long) (in a)
ᎴᏍᏗ	Deverbal	ᎦᎳ:Container (something long) (in a)
ᎴᏍᏛᎢ	RemotePast	ᎦᎳ:Container (something long) (in a)
ᎴᏓ	Immediate	ᎦᎴᏗᎭ:Burning it
ᎴᏔᏅᎢ	RemotePast	ᎦᎴᏗᎭ:Burning it
ᎴᏗᎭ	PresentContinous	ᎦᎴᏗᎭ:Burning it
ᎴᏗᏍᎪᎢ	Habitual	ᎦᎴᏗᎭ:Burning it
ᎴᏙᏗ	Deverbal	ᎦᎴᏗᎭ:Burning it
ᎴᏴᎥᎭ	Immediate	ᎦᎴᏴᏍᎦ:Hot
ᎴᏴᎯᏍᏗ	Deverbal	ᎦᎴᏴᏍᎦ:Hot
ᎴᏴᏍᎦ	PresentContinous	ᎦᎴᏴᏍᎦ:Hot
ᎴᏴᏍᎪᎢ	Habitual	ᎦᎴᏴᏍᎦ:Hot
ᎴᏴᏍᏓ	Immediate	ᎦᎴᏴᏍᏗᎭ:Cutting a tree
ᎴᏴᏍᏔᏅᎢ	RemotePast	ᎦᎴᏴᏍᏗᎭ:Cutting a tree
ᎴᏴᏍᏗᎭ	PresentContinous	ᎦᎴᏴᏍᏗᎭ:Cutting a tree
ᎴᏴᏍᏗᏍᎪᎢ	Habitual	ᎦᎴᏴᏍᏗᎭ:Cutting a tree
ᎴᏴᏍᏙᏗ	Deverbal	ᎦᎴᏴᏍᏗᎭ:Cutting a tree
ᎴᏴᏒᎢ	RemotePast	ᎦᎴᏴᏍᎦ:Hot
ᎵᎠᎦᎢᎭ	PresentContinous	ᎦᎵᎠᎦᎢᎭ:Perspiring
ᎵᎠᎦᎢᏍᎪᎢ	Habitual	ᎦᎵᎠᎦᎢᎭ:Perspiring
ᎵᎠᎦᎢᏗ	Deverbal	ᎦᎵᎠᎦᎢᎭ:Perspiring
ᎵᎠᎦᎦ	Immediate	ᎦᎵᎠᎦᎢᎭ:Perspiring
ᎵᎠᎦᏒᎢ	RemotePast	ᎦᎵᎠᎦᎢᎭ:Perspiring
ᎵᎡᏂᎠ	PresentContinous	ᎠᎵᎡᏂᎠ:Crippled
ᎵᎡᏂᎡᏍᏔ	Immediate	ᎠᎵᎡᏂᎠ:Crippled
ᎵᎡᏂᎡᏍᏗ	Deverbal	ᎠᎵᎡᏂᎠ:Crippled
ᎵᎡᏂᎡᏍᏛᎢ	RemotePast	ᎠᎵᎡᏂᎠ:Crippled
ᎵᎡᏂᎣᎢ	Habitual	ᎠᎵᎡᏂᎠ:Crippled
ᎵᎥᎦ	Immediate	ᎦᎵᎥᏂᎭ:Beating him up
ᎵᎥᏂᎭ	PresentContinous	ᎦᎵᎥᏂᎭ:Beating him up
ᎵᎥᏂᎰᎢ	Habitual	ᎦᎵᎥᏂᎭ:Beating him up
ᎵᎥᏂᎸᎢ	RemotePast	ᎦᎵᎥᏂᎭ:Beating him up
ᎵᎥᏍᏗ	Deverbal	ᎦᎵᎥᏂᎭ:Beating him up
ᎵᎪᏁᎭ	PresentContinous	ᎠᎵᎪᏁᎭ:Wishing to accompany
ᎵᎪᏁᎰᎢ	Habitual	ᎠᎵᎪᏁᎭ:Wishing to accompany
ᎵᎪᏁᎸᎢ	RemotePast	ᎠᎵᎪᏁᎭ:Wishing to accompany
ᎵᎪᏁᏗ	Deverbal	ᎠᎵᎪᏁᎭ:Wishing to accompany
ᎵᎬᎦ	Immediate	ᎠᎵᎬᎩᎠ:Ripping
ᎵᎬᎩᎠ	PresentContinous	ᎠᎵᎬᎩᎠ:Ripping
ᎵᎬᎩᏍᎪᎢ	Habitual	ᎠᎵᎬᎩᎠ:Ripping
ᎵᎬᎩᏍᏗ	Deverbal	ᎠᎵᎬᎩᎠ:Ripping
ᎵᎬᎩᏒᎢ	RemotePast	ᎠᎵᎬᎩᎠ:Ripping
ᎵᎭ	PresentContinous	ᎦᎵᎭ:Asleep
ᎵᎮᎵᏤᎭ	PresentContinous	ᎠᎵᎮᎵᏤᎭ:Thanking him
ᎵᎮᎵᏤᎰᎢ	Habitual	ᎠᎵᎮᎵᏤᎭ:Thanking him
ᎵᎮᎵᏤᎸᎢ	RemotePast	ᎠᎵᎮᎵᏤᎭ:Thanking him
ᎵᎮᎵᏤᏗ	Deverbal	ᎠᎵᎮᎵᏤᎭ:Thanking him
ᎵᎰᎢ	Habitual	ᎦᎵᎭ:Asleep
ᎵᏃᎮᏔᏅᎢ	RemotePast	ᎠᎵᏃᎮᏗᎭ:Speaking to him
ᎵᏃᎮᏗᎭ	PresentContinous	ᎠᎵᏃᎮᏗᎭ:Speaking to him
ᎵᏃᎮᏗᏍᎪᎢ	Habitual	ᎠᎵᏃᎮᏗᎭ:Speaking to him
ᎵᏃᎮᏙᏗ	Deverbal	ᎠᎵᏃᎮᏗᎭ:Speaking to him
ᎵᏌ	Immediate	ᎦᎵᏏᎭ:Removing something long from a container
ᎵᏌᎳᏅᎢ	RemotePast	ᎠᎵᏌᎵᎭ:Teasing him
ᎵᏌᎵᎭ	PresentContinous	ᎠᎵᏌᎵᎭ:Teasing him
ᎵᏌᎵᏍᎪᎢ	Habitual	ᎠᎵᏌᎵᎭ:Teasing him
ᎵᏌᎵᏗ	Deverbal	ᎠᎵᏌᎵᎭ:Teasing him
ᎵᏍᏆᏓ	Immediate	ᎤᎵᏍᏆᏗᎠ:Has an earache
ᎵᏍᏆᏗᎠ	PresentContinous	ᎤᎵᏍᏆᏗᎠ:Has an earache
ᎵᏍᏆᏗᏍᎪᎢ	Habitual	ᎤᎵᏍᏆᏗᎠ:Has an earache
ᎵᏍᏆᏗᏍᏗ	Deverbal	ᎤᎵᏍᏆᏗᎠ:Has an earache
ᎵᏍᏆᏛᎢ	RemotePast	ᎤᎵᏍᏆᏗᎠ:Has an earache
ᎵᏍᏇᏚᎠ	Immediate	ᏂᎦᎵᏍᏇᏚᎢᎭ:Because of
ᎵᏍᏇᏚᎠᏅᎢ	RemotePast	ᏂᎦᎵᏍᏇᏚᎢᎭ:Because of
ᎵᏍᏇᏚᎢᎭ	PresentContinous	ᏂᎦᎵᏍᏇᏚᎢᎭ:Because of
ᎵᏍᏇᏚᎢᏍᎪᎢ	Habitual	ᏂᎦᎵᏍᏇᏚᎢᎭ:Because of
ᎵᏍᏚᎦ	Immediate	ᎠᎵᏍᏚᎩᎠ:Pulling leaves off of a tree
ᎵᏍᏚᎩᎠ	PresentContinous	ᎠᎵᏍᏚᎩᎠ:Pulling leaves off of a tree
ᎵᏍᏚᎩᏍᎪᎢ	Habitual	ᎠᎵᏍᏚᎩᎠ:Pulling leaves off of a tree
ᎵᏍᏚᎩᏍᏗ	Deverbal	ᎠᎵᏍᏚᎩᎠ:Pulling leaves off of a tree
ᎵᏍᏚᎩᏒᎢ	RemotePast	ᎠᎵᏍᏚᎩᎠ:Pulling leaves off of a tree
ᎵᏏᎭ	PresentContinous	ᎦᎵᏏᎭ:Removing something long from a container
ᎵᏏᏍᎪᎢ	Habitual	ᎦᎵᏏᎭ:Removing something long from a container
ᎵᏒᎲᎢ	RemotePast	ᎦᎵᏏᎭ:Removing something long from a container
ᎵᏒᏗ	Deverbal	ᎦᎵᏏᎭ:Removing something long from a container
ᎵᏦᏔᎦ	Immediate	ᎧᎵᏦᏔᏍᎦ:Roofing a house
ᎵᏦᏔᏅᎢ	RemotePast	ᎧᎵᏦᏔᏍᎦ:Roofing a house
ᎵᏦᏔᏍᎦ	PresentContinous	ᎧᎵᏦᏔᏍᎦ:Roofing a house
ᎵᏦᏔᏍᎪᎢ	Habitual	ᎧᎵᏦᏔᏍᎦ:Roofing a house
ᎵᏦᏘᏗ	Deverbal	ᎧᎵᏦᏔᏍᎦ:Roofing a house
ᎶᎠ	PresentContinous	ᎦᎶᎠ:Breaking something solid
ᎶᎡᏍᏛᎢ	RemotePast	ᏚᎶᏒᎯ:From
ᎶᎢ	Habitual	ᎦᎳ:Container (something long) (in a)
ᎶᎣᎭ	Immediate	ᎦᎶᎣᏍᎦ:Falling (something alive)
ᎶᎣᎯᏍᏗ	Deverbal	ᎦᎶᎣᏍᎦ:Falling (something alive)
ᎶᎣᏅᏓ	Immediate	ᎦᎶᎣᏅᏗᎭ:Making him fall
ᎶᎣᏅᏔᏅᎢ	RemotePast	ᎦᎶᎣᏅᏗᎭ:Making him fall
ᎶᎣᏅᏗᎭ	PresentContinous	ᎦᎶᎣᏅᏗᎭ:Making him fall
ᎶᎣᏅᏗᏍᎪᎢ	Habitual	ᎦᎶᎣᏅᏗᎭ:Making him fall
ᎶᎣᏅᏙᏗ	Deverbal	ᎦᎶᎣᏅᏗᎭ:Making him fall
ᎶᎣᏍᎦ	PresentContinous	ᎦᎶᎣᏍᎦ:Falling (something alive)
ᎶᎣᏍᎪᎢ	Habitual	ᎦᎶᎣᏍᎦ:Falling (something alive)
ᎶᎣᏒᎢ	RemotePast	ᎦᎶᎣᏍᎦ:Falling (something alive)
ᎶᎥᎢ	RemotePast	ᎦᎶᎠ:Breaking something solid
ᎶᎦᎦ	Immediate	ᎦᎶᎩᎠ:Hoeing
ᎶᎦᏅᎢ	RemotePast	ᎦᎶᎩᎠ:Hoeing
ᎶᎨᎴᏒᎢ	RemotePast	ᏕᎦᎶᎨᎵ:Going across a hill
ᎶᎨᎵ	PresentContinous	ᏕᎦᎶᎨᎵ:Going across a hill
ᎶᎨᎵᏐᎢ	Habitual	ᏕᎦᎶᎨᎵ:Going across a hill
ᎶᎨᎷᎦ	Immediate	ᏕᎦᎶᎨᎵ:Going across a hill
ᎶᎨᎸᏍᏗ	Deverbal	ᏕᎦᎶᎨᎵ:Going across a hill
ᎶᎨᏓ	Immediate	ᎦᎶᎨᏗᎠ:Clearing a field
ᎶᎨᏗᎠ	PresentContinous	ᎦᎶᎨᏗᎠ:Clearing a field
ᎶᎨᏗᏍᎪᎢ	Habitual	ᎦᎶᎨᏗᎠ:Clearing a field
ᎶᎨᏗᏍᏗ	Deverbal	ᎦᎶᎨᏗᎠ:Clearing a field
ᎶᎨᏛᎢ	RemotePast	ᎦᎶᎨᏗᎠ:Clearing a field
ᎶᎩᎠ	PresentContinous	ᎦᎶᎩᎠ:Hoeing
ᎶᎩᏍᎪᎢ	Habitual	ᎦᎶᎩᎠ:Hoeing
ᎶᎪᎰᎦ	Immediate	ᎦᎶᎪᎰᏍᎦ:Leaves are turning
ᎶᎪᎰᏍᎦ	PresentContinous	ᎦᎶᎪᎰᏍᎦ:Leaves are turning
ᎶᎪᎰᏍᎪᎢ	Habitual	ᎦᎶᎪᎰᏍᎦ:Leaves are turning
ᎶᎪᎰᏍᏗ	Deverbal	ᎦᎶᎪᎰᏍᎦ:Leaves are turning
ᎶᎪᎰᏒᎢ	RemotePast	ᎦᎶᎪᎰᏍᎦ:Leaves are turning
ᎶᎪᏗ	Deverbal	ᎦᎶᎩᎠ:Hoeing
ᎶᎭ	Immediate	ᏚᎶᏒᎯ:From	ᎠᎶᏍᎦ:Winning
ᎶᎯᏍᏓ	Immediate	ᎦᎶᎯᏍᏗᎭ:Passing a bill (legislation)
ᎶᎯᏍᏔᏅᎢ	RemotePast	ᎦᎶᎯᏍᏗᎭ:Passing a bill (legislation)
ᎶᎯᏍᏗ	Deverbal	ᏚᎶᏒᎯ:From	ᎠᎶᏍᎦ:Winning
ᎶᎯᏍᏗᎭ	PresentContinous	ᎦᎶᎯᏍᏗᎭ:Passing a bill (legislation)
ᎶᎯᏍᏗᏍᎪᎢ	Habitual	ᎦᎶᎯᏍᏗᎭ:Passing a bill (legislation)
ᎶᎯᏍᏙᏗ	Deverbal	ᎦᎶᎯᏍᏗᎭ:Passing a bill (legislation)
ᎶᎯᏎᎭ	PresentContinous	ᎦᎶᎯᏎᎭ:Passing by
ᎶᎯᏎᎰᎢ	Habitual	ᎦᎶᎯᏎᎭ:Passing by
ᎶᎯᏎᎸᎢ	RemotePast	ᎦᎶᎯᏎᎭ:Passing by
ᎶᎯᏎᏌ	Immediate	ᎦᎶᎯᏎᎭ:Passing by
ᎶᎯᏎᏗ	Deverbal	ᎦᎶᎯᏎᎭ:Passing by
ᎶᎳ	PresentContinous	ᎤᎶᎳ:Lacking
ᎶᎳᎦ	Immediate	ᎤᎶᎳ:Lacking
ᎶᎳᏅᎢ	RemotePast	ᎤᎶᎳ:Lacking
ᎶᎶᎢ	Habitual	ᎤᎶᎳ:Lacking
ᎶᎶᏗ	Deverbal	ᎤᎶᎳ:Lacking
ᎶᏅᎡᎭ	PresentContinous	ᎦᎶᏅᎡᎭ:Outwitting him
ᎶᏅᎡᎸᎢ	RemotePast	ᎦᎶᏅᎡᎭ:Outwitting him
ᎶᏅᎡᏍᎪᎢ	Habitual	ᎦᎶᏅᎡᎭ:Outwitting him
ᎶᏅᎡᏗ	Deverbal	ᎦᎶᏅᎡᎭ:Outwitting him
ᎶᏅᎥᎠ	Immediate	ᎦᎶᏅᎮᎭ:Cheating
ᎶᏅᎥᎳ	Immediate	ᎦᎶᏅᎡᎭ:Outwitting him
ᎶᏅᎮᎭ	PresentContinous	ᎦᎶᏅᎮᎭ:Cheating
ᎶᏅᎮᎸᎢ	RemotePast	ᎦᎶᏅᎮᎭ:Cheating
ᎶᏅᎮᏍᎪᎢ	Habitual	ᎦᎶᏅᎮᎭ:Cheating
ᎶᏅᎮᏗ	Deverbal	ᎦᎶᏅᎮᎭ:Cheating
ᎶᏅᏤᎭ	PresentContinous	ᎤᎶᏅᏤᎭ:Anxious
ᎶᏅᏤᎰᎢ	Habitual	ᎤᎶᏅᏤᎭ:Anxious
ᎶᏅᏤᎸᎢ	RemotePast	ᎤᎶᏅᏤᎭ:Anxious
ᎶᏅᏤᏌ	Immediate	ᎤᎶᏅᏤᎭ:Anxious
ᎶᏅᏤᏍᏗ	Deverbal	ᎤᎶᏅᏤᎭ:Anxious
ᎶᏍᎦ	PresentContinous	ᎠᎶᏍᎦ:Winning
ᎶᏍᎪᎢ	Habitual	ᎦᎶᎠ:Breaking something solid	ᎠᎶᏍᎦ:Winning
ᎶᏍᏗ	Deverbal	ᎦᎶᎠ:Breaking something solid
ᎶᏒᎢ	RemotePast	ᎠᎶᏍᎦ:Winning
ᎶᏒᎯ	Habitual	ᏚᎶᏒᎯ:From
ᎶᏔᏅᎥᎦ	Immediate	ᎦᎶᏔᏅᎥᏍᎦ:Preserving it
ᎶᏔᏅᎥᏍᎦ	PresentContinous	ᎦᎶᏔᏅᎥᏍᎦ:Preserving it
ᎶᏔᏅᎥᏍᎪᎢ	Habitual	ᎦᎶᏔᏅᎥᏍᎦ:Preserving it
ᎶᏔᏅᏅᎢ	RemotePast	ᎦᎶᏔᏅᎥᏍᎦ:Preserving it
ᎶᏔᏅᏗ	Deverbal	ᎦᎶᏔᏅᎥᏍᎦ:Preserving it
ᎶᏕᎯᎭ	PresentContinous	ᎠᎶᏕᎯᎭ:Kicking
ᎶᏕᎯᎰᎢ	Habitual	ᎠᎶᏕᎯᎭ:Kicking
ᎶᏕᎸᎢ	RemotePast	ᎠᎶᏕᎯᎭ:Kicking
ᎶᏕᏍᏗ	Deverbal	ᎠᎶᏕᎯᎭ:Kicking
ᎶᏣ	Immediate	ᎦᎶᎠ:Breaking something solid
ᎷᎦ	Immediate	ᎢᎦᎷᎧ:Returning	ᎠᎯᎭ:Killing
ᎷᎧ	PresentContinous	ᎢᎦᎷᎧ:Returning
ᎷᎪᎢ	Habitual	ᎢᎦᎷᎧ:Returning
ᎷᎯᏍᏗ	Deverbal	ᎢᎦᎷᎧ:Returning
ᎷᏨᎢ	RemotePast	ᎢᎦᎷᎧ:Returning
ᎷᏯ	Immediate	ᎦᎷᏱᏍᎦ:Cutting it with an axe
ᎷᏱᎲᎢ	RemotePast	ᎦᎷᏱᏍᎦ:Cutting it with an axe
ᎷᏱᏍᎦ	PresentContinous	ᎦᎷᏱᏍᎦ:Cutting it with an axe
ᎷᏱᏍᎪᎢ	Habitual	ᎦᎷᏱᏍᎦ:Cutting it with an axe
ᎷᏱᏍᏗ	Deverbal	ᎦᎷᏱᏍᎦ:Cutting it with an axe
ᎸᎡᏍᏔ	Immediate	ᎦᎸᏍᎦ:Sleepy
ᎸᎡᏍᏛᎢ	RemotePast	ᎦᎸᏍᎦ:Sleepy
ᎸᎢ	RemotePast	ᎠᎯᎭ:Killing
ᎸᎣᏗ	Deverbal	ᎦᎸᏍᎦ:Sleepy
ᎸᎥᎦ	Immediate	ᎦᎸᎥᏍᎦ:Putting something flexible or something alive into a container
ᎸᎥᏍᎦ	PresentContinous	ᎦᎸᎥᏍᎦ:Putting something flexible or something alive into a container
ᎸᎥᏍᎪᎢ	Habitual	ᎦᎸᎥᏍᎦ:Putting something flexible or something alive into a container
ᎸᎦ	Immediate	ᎦᎳᎠ:Container (something solid) (in a)
ᎸᎾ	Immediate	ᎦᎵᎭ:Asleep
ᎸᏅᎢ	RemotePast	ᎦᎵᎭ:Asleep	ᎦᎸᎥᏍᎦ:Putting something flexible or something alive into a container
ᎸᏅᏓ	Immediate	ᎤᎸᏅᏗᎭ:Crazy
ᎸᏅᏔᏅᎢ	RemotePast	ᎤᎸᏅᏗᎭ:Crazy
ᎸᏅᏗᎭ	PresentContinous	ᎤᎸᏅᏗᎭ:Crazy
ᎸᏅᏗᏍᎪᎢ	Habitual	ᎤᎸᏅᏗᎭ:Crazy
ᎸᏅᏙᏗ	Deverbal	ᎤᎸᏅᏗᎭ:Crazy
ᎸᏉᏓ	Immediate	ᎦᎸᏉᏗᎭ:Loving it
ᎸᏉᏓᏅᎢ	RemotePast	ᎦᎸᏉᏗᎭ:Loving it
ᎸᏉᏔᏅᎢ	RemotePast	ᎦᎸᏉᏗᎭ:Glorifying it
ᎸᏉᏗᎭ	PresentContinous	ᎦᎸᏉᏗᎭ:Glorifying it
ᎸᏉᏗᏍᎪᎢ	Habitual	ᎦᎸᏉᏗᎭ:Loving it
ᎸᏉᏘᏗ	Deverbal	ᎦᎸᏉᏗᎭ:Glorifying it
ᎸᏉᏙᏗ	Deverbal	ᎦᎸᏉᏗᎭ:Loving it
ᎸᏍᎦ	PresentContinous	ᎦᎸᏍᎦ:Sleepy
ᎸᏍᎪᎢ	Habitual	ᎦᎸᏍᎦ:Sleepy
ᎸᏓᎳᎦ	Immediate	ᎦᎸᏓᏍᎦ:Cutting into strips
ᎸᏓᏅᎢ	RemotePast	ᎦᎸᏓᏍᎦ:Cutting into strips
ᎸᏓᏍᎦ	PresentContinous	ᎦᎸᏓᏍᎦ:Cutting into strips
ᎸᏓᏍᎪᎢ	Habitual	ᎦᎸᏓᏍᎦ:Cutting into strips
ᎸᏔᎳᏗ	Deverbal	ᎦᎸᏓᏍᎦ:Cutting into strips
ᎸᏗ	Deverbal	ᎦᎸᎥᏍᎦ:Putting something flexible or something alive into a container	ᎦᎵᎭ:Asleep
ᎸᏛᎾ	Immediate	ᎧᎸᏛᏂᎠ:Telephoning
ᎸᏛᏂᎠ	PresentContinous	ᎧᎸᏛᏂᎠ:Telephoning
ᎸᏛᏂᎦ	Immediate	ᎦᎸᏛᏂᎭ:Telephoning (idiom)
ᎸᏛᏂᎭ	PresentContinous	ᎦᎸᏛᏂᎭ:Telephoning (idiom)
ᎸᏛᏂᎰᎢ	Habitual	ᎦᎸᏛᏂᎭ:Telephoning (idiom)
ᎸᏛᏂᎸᎢ	RemotePast	ᎦᎸᏛᏂᎭ:Telephoning (idiom)
ᎸᏛᏂᏍᎪᎢ	Habitual	ᎧᎸᏛᏂᎠ:Telephoning
ᎸᏛᏂᏍᏗ	Deverbal	ᎦᎸᏛᏂᎭ:Telephoning (idiom)
ᎸᏛᏅᎢ	RemotePast	ᎧᎸᏛᏂᎠ:Telephoning
ᎸᏛᏅᏗ	Deverbal	ᎧᎸᏛᏂᎠ:Telephoning
ᎸᏪᎠ	PresentContinous	ᎦᎸᏪᎠ:Winding thread or yarn
ᎸᏪᎢᏍᏗ	Deverbal	ᎦᎸᏪᎠ:Winding thread or yarn
ᎸᏪᎥᎢ	RemotePast	ᎦᎸᏪᎠ:Winding thread or yarn
ᎸᏪᏍᎪᎢ	Habitual	ᎦᎸᏪᎠ:Winding thread or yarn
ᎸᏪᏯᎦ	Immediate	ᎦᎸᏪᏯᎩᎠ:Unwinding it
ᎸᏪᏯᎩᎠ	PresentContinous	ᎦᎸᏪᏯᎩᎠ:Unwinding it
ᎸᏪᏯᎩᏍᎪᎢ	Habitual	ᎦᎸᏪᏯᎩᎠ:Unwinding it
ᎸᏪᏯᎩᏍᏗ	Deverbal	ᎦᎸᏪᏯᎩᎠ:Unwinding it
ᎸᏪᏯᎩᏒᎢ	RemotePast	ᎦᎸᏪᏯᎩᎠ:Unwinding it
ᎸᏪᏯᏍᏓ	Immediate	ᎦᎸᏪᏯᏍᏗᎭ:Winding it up
ᎸᏪᏯᏍᏔᏅᎢ	RemotePast	ᎦᎸᏪᏯᏍᏗᎭ:Winding it up
ᎸᏪᏯᏍᏗᎭ	PresentContinous	ᎦᎸᏪᏯᏍᏗᎭ:Winding it up
ᎸᏪᏯᏍᏗᏍᎪᎢ	Habitual	ᎦᎸᏪᏯᏍᏗᎭ:Winding it up
ᎸᏪᏯᏍᏙᏗ	Deverbal	ᎦᎸᏪᏯᏍᏗᎭ:Winding it up
ᎸᏫᏍᏓᏁᎭ	PresentContinous	ᏚᎸᏫᏍᏓᏁᎭ:Working
ᎸᏫᏍᏓᏁᎰᎢ	Habitual	ᏚᎸᏫᏍᏓᏁᎭ:Working
ᎸᏫᏍᏓᏁᎸᎢ	RemotePast	ᏚᎸᏫᏍᏓᏁᎭ:Working
ᎸᏫᏍᏓᏁᏗ	Deverbal	ᏚᎸᏫᏍᏓᏁᎭ:Working
ᎸᏫᏍᏓᏌ	Immediate	ᏚᎸᏫᏍᏓᏁᎭ:Working
ᎾᎠ	PresentContinous	ᎤᎾᎠ:Has something flexible	ᎦᎾᎠ:Lying down
ᎾᎡᎳᏓ	Immediate	ᎦᎾᎩᎳ:Residing (Qualla Dialect)
ᎾᎡᎳᏗᏍᏗ	Deverbal	ᎦᎾᎩᎳ:Residing (Qualla Dialect)
ᎾᎡᎳᏛᎢ	RemotePast	ᎦᎾᎩᎳ:Residing (Qualla Dialect)
ᎾᎡᏍᏔ	Immediate	ᎤᎾᎠ:Has something flexible
ᎾᎡᏍᏗ	Deverbal	ᎤᎾᎠ:Has something flexible
ᎾᎡᏍᏛᎢ	RemotePast	ᎤᎾᎠ:Has something flexible
ᎾᎣᎢ	Habitual	ᎤᎾᎠ:Has something flexible	ᎦᎾᎠ:Lying down
ᎾᎥᎦ	Immediate	ᎦᎾᎠ:Lying down	ᎦᎾᎥᏍᎦ:Placing something alive on a raised surface
ᎾᎥᏂ	Other	ᎾᎥᏂ:Near
ᎾᎥᏍᎦ	PresentContinous	ᎦᎾᎥᏍᎦ:Placing something alive on a raised surface
ᎾᎥᏍᎪᎢ	Habitual	ᎦᎾᎥᏍᎦ:Placing something alive on a raised surface
ᎾᎦ	Immediate	ᎦᎾᎩᎠ:Picking up something flexible	ᎦᏁᎠ:Picking up something flexible
ᎾᎦᎸᎢᏍᏗ	Deverbal	ᎤᎾᎦᎸᎦ:Angry (becoming)	ᎤᎾᎦᎸᎭ:Angry
ᎾᎦᎸᎦ	Immediate	ᎤᎾᎦᎸᎦ:Angry (becoming)	ᎤᎾᎦᎸᎭ:Angry
ᎾᎦᎸᎪᎢ	Habitual	ᎤᎾᎦᎸᎦ:Angry (becoming)
ᎾᎦᎸᎭ	PresentContinous	ᎤᎾᎦᎸᎭ:Angry
ᎾᎦᎸᎰᎢ	Habitual	ᎤᎾᎦᎸᎭ:Angry
ᎾᎦᎸᏨᎢ	RemotePast	ᎤᎾᎦᎸᎭ:Angry	ᎤᎾᎦᎸᎦ:Angry (becoming)
ᎾᎨᎢ	Other	ᎾᎨᎢ:Genus: Populus Candicans
ᎾᎩᎠ	PresentContinous	ᎦᎾᎩᎠ:Picking up something flexible or something alive from the ground	ᎦᎾᎩᎡᎭ:Taking something flexible or something alive from him
ᎾᎩᎡᎭ	PresentContinous	ᎦᎾᎩᎡᎭ:Taking something flexible or something alive from him
ᎾᎩᎡᎰᎢ	Habitual	ᎦᎾᎩᎡᎭ:Taking something flexible or something alive from him
ᎾᎩᎡᎸᎢ	RemotePast	ᎦᎾᎩᎡᎭ:Taking something flexible or something alive from him
ᎾᎩᎡᏗ	Deverbal	ᎦᎾᎩᎡᎭ:Taking something flexible or something alive from him
ᎾᎩᎳ	PresentContinous	ᎦᎾᎩᎳ:Residing (Qualla Dialect)
ᎾᎩᎶᎢ	Habitual	ᎦᎾᎩᎳ:Residing (Qualla Dialect)
ᎾᎩᏍᎪᎢ	Habitual	ᎦᎾᎩᎠ:Picking up something flexible or something alive from the ground
ᎾᎩᏍᏗ	Deverbal	ᎦᎾᎩᎠ:Picking up something flexible
ᎾᎩᏎᎪᎢ	Habitual	ᎦᎾᎩᏏ:Fetching something flexible or something alive
ᎾᎩᏎᏒᎢ	RemotePast	ᎦᎾᎩᏏ:Fetching something flexible or something alive
ᎾᎩᏏ	PresentContinous	ᎦᎾᎩᏏ:Fetching something flexible or something alive
ᎾᎩᏑᎦ	Immediate	ᎦᎾᎩᏏ:Fetching something flexible or something alive
ᎾᎩᏒᎢ	RemotePast	ᎦᎾᎩᎠ:Picking up something flexible or something alive from the ground
ᎾᎩᏒᏍᏗ	Deverbal	ᎦᎾᎩᏏ:Fetching something flexible or something alive
ᎾᎬᎠ	PresentContinous	ᎦᎾᎬᎠ:Moving something flexible off
ᎾᎬᏍᎪᎢ	Habitual	ᎦᎾᎬᎠ:Moving something flexible off
ᎾᎬᏍᏔ	Immediate	ᎦᎾᎬᎠ:Moving something flexible off
ᎾᎬᏍᏗ	Deverbal	ᎦᎾᎬᎠ:Moving something flexible off
ᎾᎬᏒᎢ	RemotePast	ᎦᎾᎬᎠ:Moving something flexible off
ᎾᎷᎭ	Immediate	ᎧᎾᎷᏍᎦ:Climbing a hill
ᎾᎷᎯᏍᏗ	Deverbal	ᎧᎾᎷᏍᎦ:Going up a hill
ᎾᎷᏍᎦ	PresentContinous	ᎧᎾᎷᏍᎦ:Climbing a hill
ᎾᎷᏍᎪᎢ	Habitual	ᎧᎾᎷᏍᎦ:Going up a hill
ᎾᎷᏒᎢ	RemotePast	ᎧᎾᎷᏍᎦ:Going up a hill
ᎾᏅᎢ	RemotePast	ᎦᎾᎥᏍᎦ:Placing something alive on a raised surface
ᎾᏉ	Other	ᎾᏉ:There
ᎾᏍᎦᏎᏅᎾ	Other	ᏍᎦᏎᏅ:Fearless
ᎾᏏᏁᏒᎢ	RemotePast	ᎦᎾᏏᏂ:Dragging it
ᎾᏏᏂ	PresentContinous	ᎦᎾᏏᏂ:Dragging it
ᎾᏏᏂᏐᎢ	Habitual	ᎦᎾᏏᏂ:Dragging it
ᎾᏏᏄᎦ	Immediate	ᎦᎾᏏᏂ:Dragging it
ᎾᏏᏅᏍᏗ	Deverbal	ᎦᎾᏏᏂ:Dragging it
ᎾᏕᎡᏒᎢ	RemotePast	ᎤᎾᏕᎦ:Selling it
ᎾᏕᎤᎦ	Immediate	ᎤᎾᏕᎦ:Selling it
ᎾᏕᎥᏍᏗ	Deverbal	ᎤᎾᏕᎦ:Selling it
ᎾᏕᎦ	PresentContinous	ᎤᎾᏕᎦ:Selling it
ᎾᏕᎪᎢ	Habitual	ᎤᎾᏕᎦ:Selling it
ᎾᏗ	Deverbal	ᎦᎾᎥᏍᎦ:Placing something alive on a raised surface
ᎾᏤᎭ	PresentContinous	ᎦᎾᏤᎭ:Holding something liquid
ᎾᏤᎮᏍᏔ	Immediate	ᎦᎾᏤᎭ:Holding something liquid
ᎾᏤᎮᏍᏗ	Deverbal	ᎦᎾᏤᎭ:Holding something liquid
ᎾᏤᎮᏍᏛᎢ	RemotePast	ᎦᎾᏤᎭ:Holding something liquid
ᎾᏤᎰᎢ	Habitual	ᎦᎾᏤᎭ:Holding something liquid
ᎾᏤᏒᎢ	RemotePast	ᎦᎾᏥ:Carrying something liquid
ᎾᏥ	PresentContinous	ᎦᎾᏥ:Carrying something liquid
ᎾᏥᏐᎢ	Habitual	ᎦᎾᏥ:Carrying something liquid
ᎾᏦᏍᏓ	Immediate	ᏕᎦᎾᏦᏍᏗᎭ:Pickling
ᎾᏦᏍᏔᏅᎢ	RemotePast	ᏕᎦᎾᏦᏍᏗᎭ:Pickling
ᎾᏦᏍᏗᎭ	PresentContinous	ᏕᎦᎾᏦᏍᏗᎭ:Pickling
ᎾᏦᏍᏗᏍᎪᎢ	Habitual	ᏕᎦᎾᏦᏍᏗᎭ:Pickling
ᎾᏦᏍᏙᏗ	Deverbal	ᏕᎦᎾᏦᏍᏗᎭ:Pickling
ᎾᏧᎦ	Immediate	ᎦᎾᏥ:Carrying something liquid
ᎾᏨᏍᏓ	Immediate	ᎦᎾᏨᏍᏗᎭ:Being carried by something liquid
ᎾᏨᏍᏔᏅᎢ	RemotePast	ᎦᎾᏨᏍᏗᎭ:Being carried by something liquid
ᎾᏨᏍᏗ	Deverbal	ᎦᎾᏥ:Carrying something liquid
ᎾᏨᏍᏗᎭ	PresentContinous	ᎦᎾᏨᏍᏗᎭ:Being carried by something liquid
ᎾᏨᏍᏗᏍᎪᎢ	Habitual	ᎦᎾᏨᏍᏗᎭ:Being carried by something liquid
ᎾᏨᏍᏙᏗ	Deverbal	ᎦᎾᏨᏍᏗᎭ:Being carried by something liquid
ᎾᏩ	Immediate	ᎤᎾᏫᎠ:Trembling
ᎾᏫᎠ	PresentContinous	ᎤᎾᏫᎠ:Trembling
ᎾᏫᎠᎪᎢ	Habitual	ᎤᎾᏫᎠ:Trembling
ᎾᏫᎢᏍᏗ	Deverbal	ᎤᎾᏫᎠ:Trembling
ᎾᏫᏓ	Immediate	ᎦᎾᏫᏗᎭ:Carrying something flexible or something alive off
ᎾᏫᏔ	Immediate	ᎦᎾᏫᏘᎭ:Finding something flexible or something alive
ᎾᏫᏗᎭ	PresentContinous	ᎦᎾᏫᏗᎭ:Carrying something flexible or something alive off
ᎾᏫᏗᏍᎪᎢ	Habitual	ᎦᎾᏫᏗᎭ:Carrying something flexible or something alive off
ᎾᏫᏘᎭ	PresentContinous	ᎦᎾᏫᏘᎭ:Finding something flexible or something alive
ᎾᏫᏘᏍᎪᎢ	Habitual	ᎦᎾᏫᏘᎭ:Finding something flexible or something alive
ᎾᏫᏘᏗ	Deverbal	ᎦᎾᏫᏗᎭ:Carrying something flexible or something alive off
ᎾᏫᏛᎲᎢ	RemotePast	ᎦᎾᏫᏘᎭ:Finding something flexible or something alive	ᎦᎾᏫᏗᎭ:Carrying something flexible or something alive off
ᎾᏫᏛᏗ	Deverbal	ᎦᎾᏫᏘᎭ:Finding something flexible or something alive
ᎾᏬᎢᏍᏗ	Deverbal	ᎧᎾᏬᎦ:Cold
ᎾᏬᎦ	Immediate	ᎧᎾᏬᎦ:Cold
ᎾᏬᎪᎢ	Habitual	ᎧᎾᏬᎦ:Cold
ᎾᏬᏨᎢ	RemotePast	ᎧᎾᏬᎦ:Cold
ᎾᏮᎢ	RemotePast	ᎤᎾᏫᎠ:Trembling
Ꮑ&lt;k&gt;ᏍᎪᎯ	Other	Ꮑ&lt;k&gt;ᏍᎪᎯ:Eighty
ᏁᎠ	PresentContinous	ᎦᏁᎠ:Picking up something flexible
ᏁᎢᏍᏗ	Deverbal	ᎧᏁᎦ:Speaking
ᏁᎥᏌ	Immediate	ᎦᏁᏁᎭ:Giving something liquid to him
ᏁᎥᏍᏗ	Deverbal	ᏓᏁᎦ:Placing solid things in a row
ᏁᎦ	Immediate	ᎦᏁᎭ:Carrying something flexible	ᎧᏁᎦ:Speaking	ᎦᏁᎩᎠ:Picking up something liquid	ᏓᏁᎦ:Placing solid things in a row
ᏁᎧ	PresentContinous	ᎦᏁᎧ:Carrying something flexible
ᏁᎩᎠ	Immediate	ᎦᏁᎩᎡᎭ:Milking	ᎦᏁᎩᎠ:Picking up something liquid
ᏁᎩᎡᎭ	PresentContinous	ᎦᏁᎩᎡᎭ:Taking something liquid from him
ᏁᎩᎡᎰᎢ	Habitual	ᎦᏁᎩᎡᎭ:Taking something liquid from him
ᏁᎩᎡᎸᎢ	RemotePast	ᎦᏁᎩᎡᎭ:Taking something liquid from him
ᏁᎩᎡᏗ	Deverbal	ᎦᏁᎩᎡᎭ:Taking something liquid from him
ᏁᎩᏍᎪᎢ	Habitual	ᎦᏁᎩᎠ:Picking up something liquid
ᏁᎩᏍᏗ	Deverbal	ᎦᏁᎩᎠ:Picking up something liquid
ᏁᎩᏎᎪᎢ	Habitual	ᎦᏁᎩᏏ:Fetching something liquid
ᏁᎩᏎᏒᎢ	RemotePast	ᎦᏁᎩᏏ:Fetching something liquid
ᏁᎩᏏ	PresentContinous	ᎦᏁᎩᏏ:Fetching something liquid
ᏁᎩᏑᎦ	Immediate	ᎦᏁᎩᏏ:Fetching something liquid
ᏁᎩᏒᎢ	RemotePast	ᎦᏁᎩᎠ:Picking up something liquid
ᏁᎩᏒᏍᏗ	Deverbal	ᎦᏁᎩᏏ:Fetching something liquid
ᏁᎪᎢ	Habitual	ᏓᏁᎦ:Placing solid things in a row	ᎦᏁᎧ:Carrying something flexible	ᎧᏁᎦ:Speaking
ᏁᎪᏳᎢᏍᏗ	Deverbal	ᎦᏁᎪᏳᎦ:Wrinkling
ᏁᎪᏳᎦ	PresentContinous	ᎦᏁᎪᏳᎦ:Wrinkling
ᏁᎪᏳᎪᎢ	Habitual	ᎦᏁᎪᏳᎦ:Wrinkling
ᏁᎪᏳᏨᎢ	RemotePast	ᎦᏁᎪᏳᎦ:Wrinkling
ᏁᎫᎢᏍᏗ	Deverbal	ᎤᏁᎫᎭ:Mean
ᏁᎫᎦ	Immediate	ᎤᏁᎫᎭ:Mean
ᏁᎫᎭ	PresentContinous	ᎤᏁᎫᎭ:Mean
ᏁᎫᎰᎢ	Habitual	ᎤᏁᎫᎭ:Mean
ᏁᎫᏣᏔ	PresentContinous	ᎤᏁᎫᏣᏔ:Mischievious
ᏁᎫᏣᏖᏍᏔ	Immediate	ᎤᏁᎫᏣᏔ:Mischievious
ᏁᎫᏣᏖᏍᏛᎢ	RemotePast	ᎤᏁᎫᏣᏔ:Mischievious
ᏁᎫᏣᏘ	Deverbal	ᎤᏁᎫᏣᏔ:Mischievious
ᏁᎫᏣᏙᎢ	Habitual	ᎤᏁᎫᏣᏔ:Mischievious
ᏁᎫᏨᎢ	RemotePast	ᎤᏁᎫᎭ:Mean
ᏁᎭ	PresentContinous	ᎦᏁᎭ:Holding something long	ᎤᏁᎭ:Has something liquid
ᏁᎮᏍᏔ	Immediate	ᎦᏁᎭ:Holding something flexible
ᏁᎮᏍᏗ	Deverbal	ᎦᏁᎭ:Holding something flexible
ᏁᎮᏍᏛᎢ	RemotePast	ᎦᏁᎭ:Holding something long
ᏁᎰᎢ	Habitual	ᎤᏁᎭ:Has something liquid	ᎦᏁᎭ:Holding something long	ᎠᎥᏏ:Handing something solid to him
ᏁᎲᎦ	Immediate	ᎤᏁᎭ:Has something liquid
ᏁᎳ	PresentContinous	ᎦᏁᎳ:Residing (Oklahoma Dialect)	ᎦᏁᎵᎭ:Disliking him
ᏁᎳᏍᎪᎯ	Other	ᏁᎳᏍᎪᎯ:Eighty
ᏁᎳᏓ	Immediate	ᎦᏁᎳ:Residing (Oklahoma Dialect)
ᏁᎳᏗᏍᏗ	Deverbal	ᎦᏁᎳ:Residing (Oklahoma Dialect)
ᏁᎳᏚᎯ	Other	ᏁᎳᏚᎯ:Eighteen
ᏁᎳᏛᎢ	RemotePast	ᎦᏁᎳ:Residing (Oklahoma Dialect)
ᏁᎳᏬᎠ	PresentContinous	ᎦᏁᎳᏬᎠ:Scalding and scraping it
ᏁᎳᏬᎥᎢ	RemotePast	ᎦᏁᎳᏬᎠ:Scalding and scraping it
ᏁᎳᏬᏍᎪᎢ	Habitual	ᎦᏁᎳᏬᎠ:Scalding and scraping it
ᏁᎳᏬᏍᏗ	Deverbal	ᎦᏁᎳᏬᎠ:Scalding and scraping it
ᏁᎳᏬᏣ	Immediate	ᎦᏁᎳᏬᎠ:Scalding and scraping it
ᏁᎵᎭ	PresentContinous	ᎦᏁᎵᎭ:Disliking him
ᏁᎵᏍᎪᎢ	Habitual	ᎦᏁᎵᎭ:Disliking him
ᏁᎵᏗ	Deverbal	ᎦᏁᎵᎭ:Disliking him
ᏁᎶᎢ	Habitual	ᎦᏁᎳ:Residing (Oklahoma Dialect)
ᏁᎸᎢ	RemotePast	ᎠᎥᏏ:Handing something solid to him
ᏁᎸᎲᎢ	RemotePast	ᎦᏁᎵᎭ:Disliking him
ᏁᏁᎭ	PresentContinous	ᎦᏁᏁᎭ:Giving something liquid to him
ᏁᏁᎰᎢ	Habitual	ᎦᏁᏁᎭ:Giving something liquid to him
ᏁᏁᎸᎢ	RemotePast	ᎦᏁᏁᎭ:Giving something liquid to him
ᏁᏁᏗ	Deverbal	ᎦᏁᏁᎭ:Giving something liquid to him
ᏁᏄᎳᎦ	Immediate	ᎦᏁᏄᎵᎠ:Challenging
ᏁᏄᎳᏅᎢ	RemotePast	ᎦᏁᏄᎵᎠ:Challenging
ᏁᏄᎵᎠ	PresentContinous	ᎦᏁᏄᎵᎠ:Challenging
ᏁᏄᎵᏍᎪᎢ	Habitual	ᎦᏁᏄᎵᎠ:Challenging
ᏁᏄᎵᏗ	Deverbal	ᎦᏁᏄᎵᎠ:Challenging
ᏁᏅᎢ	RemotePast	ᎤᏁᎭ:Has something liquid
ᏁᏍᎪᎢ	Habitual	ᎦᏁᎠ:Picking up something flexible
ᏁᏍᏆᏘᏓ	Immediate	ᏕᎦᏁᏍᏆᏘᏗᎭ:Tumbling it end over end
ᏁᏍᏆᏘᏔᏅᎢ	RemotePast	ᏕᎦᏁᏍᏆᏘᏗᎭ:Tumbling it end over end
ᏁᏍᏆᏘᏗᎭ	PresentContinous	ᏕᎦᏁᏍᏆᏘᏗᎭ:Tumbling it end over end
ᏁᏍᏆᏘᏗᏍᎪᎢ	Habitual	ᏕᎦᏁᏍᏆᏘᏗᎭ:Tumbling it end over end
ᏁᏍᏆᏘᏙᏗ	Deverbal	ᏕᎦᏁᏍᏆᏘᏗᎭ:Tumbling it end over end
ᏁᏍᏓᎳᎦ	Immediate	ᎦᏁᏍᏓᎳᎩᎠ:Thawing it out
ᏁᏍᏓᎳᎩᎠ	PresentContinous	ᎦᏁᏍᏓᎳᎩᎠ:Thawing it out
ᏁᏍᏓᎳᎩᏍᎪᎢ	Habitual	ᎦᏁᏍᏓᎳᎩᎠ:Thawing it out
ᏁᏍᏓᎳᎩᏍᏗ	Deverbal	ᎦᏁᏍᏓᎳᎩᎠ:Thawing it out
ᏁᏍᏓᎳᎩᏒᎢ	RemotePast	ᎦᏁᏍᏓᎳᎩᎠ:Thawing it out
ᏁᏍᏓᎳᏓ	Immediate	ᎤᏁᏍᏓᎳᏗᎠ:Freezing it
ᏁᏍᏓᎳᏗᎠ	PresentContinous	ᎤᏁᏍᏓᎳᏗᎠ:Freezing it
ᏁᏍᏓᎳᏗᏍᎪᎢ	Habitual	ᎤᏁᏍᏓᎳᏗᎠ:Freezing it
ᏁᏍᏓᎳᏗᏍᏗ	Deverbal	ᎤᏁᏍᏓᎳᏗᎠ:Freezing it
ᏁᏍᏓᎳᏛᎢ	RemotePast	ᎤᏁᏍᏓᎳᏗᎠ:Freezing it
ᏁᏍᏗ	Deverbal	ᎦᏁᎠ:Picking up something flexible	ᎦᏁᎭ:Holding something long
ᏁᏐᎣᎭ	Immediate	ᎦᏁᏐᎣᏍᎦ:Hailing
ᏁᏐᎣᎲᎢ	RemotePast	ᎦᏁᏐᎣᏍᎦ:Hailing
ᏁᏐᎣᏍᎦ	PresentContinous	ᎦᏁᏐᎣᏍᎦ:Hailing
ᏁᏐᎣᏍᎪᎢ	Habitual	ᎦᏁᏐᎣᏍᎦ:Hailing
ᏁᏐᎣᏍᏗ	Deverbal	ᎦᏁᏐᎣᏍᎦ:Hailing
ᏁᏒᎢ	RemotePast	ᏕᎦᏂ:Carrying something long	ᏓᏁᎦ:Placing solid things in a row	ᎦᏁᎠ:Picking up something flexible	ᎧᏂ:Bringing something alive	ᎦᏁᎧ:Carrying something flexible	ᎦᏁᎭ:Carrying something flexible
ᏁᏗ	Deverbal	ᎠᎥᏏ:Handing something solid to him	ᎤᏁᎭ:Has something liquid
ᏁᏤᎭ	PresentContinous	ᎦᏁᏤᎭ:Holding something liquid
ᏁᏤᎮᏍᏔ	Immediate	ᎦᏁᏤᎭ:Holding something liquid
ᏁᏤᎮᏍᏗ	Deverbal	ᎦᏁᏤᎭ:Holding something liquid
ᏁᏤᎮᏍᏛᎢ	RemotePast	ᎦᏁᏤᎭ:Holding something liquid
ᏁᏤᎰᎢ	Habitual	ᎦᏁᏤᎭ:Holding something liquid
ᏁᏨᎢ	RemotePast	ᎧᏁᎦ:Speaking
ᏁᏫᏓ	Immediate	ᎦᏁᏫᏗᎭ:Carrying off something liquid
ᏁᏫᏗᎭ	PresentContinous	ᎦᏁᏫᏗᎭ:Carrying off something liquid
ᏁᏫᏗᏍᎪᎢ	Habitual	ᎦᏁᏫᏗᎭ:Finding something liquid
ᏁᏫᏘᏗ	Deverbal	ᎦᏁᏫᏗᎭ:Carrying off something liquid
ᏁᏫᏛᎲᎢ	RemotePast	ᎦᏁᏫᏗᎭ:Carrying off something liquid
ᏁᏫᏛᏗ	Deverbal	ᎦᏁᏫᏗᎭ:Finding something liquid
Ꮒ	PresentContinous	ᏕᎦᏂ:Carrying something long	Ꮒ:Look!	ᎧᏂ:Bringing something alive
ᏂᎤᎩᏣᏍᎦ	PresentContinous	ᎠᏂᎤᎩᏣᏍᎦ:Hugging
ᏂᎤᎩᏣᏍᎪᎢ	Habitual	ᎠᏂᎤᎩᏣᏍᎦ:Hugging
ᏂᎦᏓ	Other	ᏂᎦᏓ:All
ᏂᎨᎢ	Other	ᏂᎨᎢ:Way off
ᏂᎨᎢᏴᏓ	Other	ᏂᎨᎢᏴᏓ:Something or things way off in the distance
ᏂᎪᎭ	Immediate	ᎤᏂᎬᎦ:Running short of
ᏂᎪᎯᎸᎢ	Other	ᏂᎪᎯᎸᎢ:Always
ᏂᎪᏒᎢ	RemotePast	ᎤᏂᎬᎦ:Running short of
ᏂᎬᎢ	Other	ᏂᎬᎢ:Everywhere
ᏂᎬᎦ	PresentContinous	ᎤᏂᎬᎦ:Running short of
ᏂᎬᎪᎢ	Habitual	ᎤᏂᎬᎦ:Running short of
ᏂᎬᏫᏍᏗ	Other	ᏂᎬᏫᏍᏗ:Looks like
ᏂᎳᏛᏱ	Other	ᏂᎳᏛᏱ:River (small)
ᏂᎵᏕᎭ	PresentContinous	ᎦᏂᎵᏕᎭ:Urging him
ᏂᎵᏕᎰᎢ	Habitual	ᎦᏂᎵᏕᎭ:Urging him
ᏂᎵᏕᎸᎢ	RemotePast	ᎦᏂᎵᏕᎭ:Urging him
ᏂᎵᏕᏗ	Deverbal	ᎦᏂᎵᏕᎭ:Urging him
ᏂᎵᏗᏌ	Immediate	ᎦᏂᎵᏕᎭ:Urging him
ᏂᏆᏘᎦ	Immediate	ᎦᏂᏆᏘᎭ:Hating him
ᏂᏆᏘᎭ	PresentContinous	ᎦᏂᏆᏘᎭ:Hating him
ᏂᏆᏘᎰᎢ	Habitual	ᎦᏂᏆᏘᎭ:Hating him
ᏂᏆᏘᎸᎢ	RemotePast	ᎦᏂᏆᏘᎭ:Hating him
ᏂᏆᏘᏍᏗ	Deverbal	ᎦᏂᏆᏘᎭ:Hating him
ᏂᏌᎣᏗ	Deverbal	ᎦᏂᏌᎲᏍᎦ:Disposing of a body
ᏂᏌᎥᎦ	Immediate	ᎦᏂᏌᎲᏍᎦ:Disposing of a body
ᏂᏌᎲᏍᎦ	PresentContinous	ᎦᏂᏌᎲᏍᎦ:Disposing of a body
ᏂᏌᎲᏍᎪᎢ	Habitual	ᎦᏂᏌᎲᏍᎦ:Disposing of a body
ᏂᏌᏅᎢ	RemotePast	ᎦᏂᏌᎲᏍᎦ:Disposing of a body
ᏂᏐᎢ	Habitual	ᎧᏂ:Bringing something alive	ᏕᎦᏂ:Carrying something long
ᏂᏓᏓ	PresentContinous	ᎦᏂᏓᏓ:Has a tail
ᏂᏓᏕᏍᏔ	Immediate	ᎦᏂᏓᏓ:Has a tail
ᏂᏓᏕᏍᏛᎢ	RemotePast	ᎦᏂᏓᏓ:Has a tail
ᏂᏓᏙᎢ	Habitual	ᎦᏂᏓᏓ:Has a tail
ᏂᏓᏛᏗ	Deverbal	ᎦᏂᏓᏓ:Has a tail
ᏂᏯ	Immediate	ᎤᏂᏯ:Holding something alive in hand	ᎦᏂᏱᎠ:Leaving something flexible	ᎦᏂᏱᎭ:Catching something thrown or chased
ᏂᏱᎠ	PresentContinous	ᎦᏂᏱᎠ:Leaving something flexible
ᏂᏱᎥᎢ	RemotePast	ᎦᏂᏱᎠ:Leaving something flexible
ᏂᏱᎭ	PresentContinous	ᎦᏂᏱᎭ:Catching something thrown or chased
ᏂᏱᏍᎪᎢ	Habitual	ᎦᏂᏱᎠ:Leaving something flexible	ᎦᏂᏱᎭ:Catching something thrown or chased
ᏂᏱᏗ	Deverbal	ᎦᏂᏱᎭ:Catching something thrown or chased	ᎦᏂᏱᎠ:Leaving something flexible
ᏂᏲᎢ	Habitual	ᎤᏂᏯ:Holding something alive in hand
ᏂᏴᎲᎢ	RemotePast	ᎤᏂᏯ:Holding something alive in hand	ᎦᏂᏱᎭ:Catching something thrown or chased
ᏂᏴᏗ	Deverbal	ᎤᏂᏯ:Holding something alive in hand
ᏃᎢ	Other	ᏃᎢ:Now
ᏃᎥᎳ	Immediate	ᎧᏃᎮᎭ:Telling
ᏃᎦ	Immediate	ᎦᏃᎯᎭ:Bringing something flexible	ᏕᎧᏃᎩᎠ:Singing
ᏃᎩᎠ	PresentContinous	ᏕᎧᏃᎩᎠ:Singing
ᏃᎩᏍᎪᎢ	Habitual	ᏕᎧᏃᎩᎠ:Singing
ᏃᎩᏍᏓ	Immediate	ᎧᏃᎩᏍᏗᎭ:Playing music
ᏃᎩᏍᏔᏅᎢ	RemotePast	ᎧᏃᎩᏍᏗᎭ:Playing music
ᏃᎩᏍᏗ	Deverbal	ᏕᎧᏃᎩᎠ:Singing
ᏃᎩᏍᏗᎭ	PresentContinous	ᎧᏃᎩᏍᏗᎭ:Playing music
ᏃᎩᏍᏗᏍᎪᎢ	Habitual	ᎧᏃᎩᏍᏗᎭ:Playing music
ᏃᎩᏍᏙᏗ	Deverbal	ᎧᏃᎩᏍᏗᎭ:Playing music
ᏃᎩᏒᎢ	RemotePast	ᏕᎧᏃᎩᎠ:Singing
ᏃᎮᎭ	PresentContinous	ᎧᏃᎮᎭ:Telling
ᏃᎮᎸᎢ	RemotePast	ᎧᏃᎮᎭ:Telling
ᏃᎮᏍᎪᎢ	Habitual	ᎧᏃᎮᎭ:Telling
ᏃᎮᏗ	Deverbal	ᎧᏃᎮᎭ:Telling
ᏃᎯᎭ	PresentContinous	ᎦᏃᎯᎭ:Bringing something flexible
ᏃᎯᎰᎢ	Habitual	ᎦᏃᎯᎭ:Bringing something flexible
ᏃᎯᎴᏒᎢ	RemotePast	ᎦᏃᎯᎵ:Flying
ᏃᎯᎵ	PresentContinous	ᎦᏃᎯᎵ:Flying
ᏃᎯᎵᏐᎢ	Habitual	ᎦᏃᎯᎵ:Flying
ᏃᎯᎷᎦ	Immediate	ᎦᏃᎯᎵ:Flying
ᏃᎯᎸᏍᏗ	Deverbal	ᎦᏃᎯᎵ:Flying
ᏃᎯᏍᏗ	Deverbal	ᎦᏃᎯᎭ:Bringing something flexible
ᏃᎴ	Other	ᏃᎴ:And
ᏃᎴᏒᎢ	RemotePast	ᎦᏃᎵ:Sneaking up on
ᏃᎵ	PresentContinous	ᎦᏃᎵ:Sneaking up on
ᏃᎵᎠ	Immediate	ᎦᏃᎵᏙᎠ:Hunting animals
ᏃᎵᎠᏍᏗ	Deverbal	ᎦᏃᎵᏙᎠ:Hunting animals
ᏃᎵᏐᎢ	Habitual	ᎦᏃᎵ:Sneaking up on
ᏃᎵᏙᎠ	PresentContinous	ᎦᏃᎵᏙᎠ:Hunting animals
ᏃᎵᏙᎣᎢ	Habitual	ᎦᏃᎵᏙᎠ:Hunting animals
ᏃᎵᏙᎸᎢ	RemotePast	ᎦᏃᎵᏙᎠ:Hunting animals
ᏃᎷᎦ	Immediate	ᎦᏃᎵ:Sneaking up on
ᏃᎸᎢ	RemotePast	ᎦᏃᎯᎭ:Bringing something flexible
ᏃᎸᎥᏍᎦ	PresentContinous	ᎦᏃᎸᎥᏍᎦ:Wind blowing
ᏃᎸᎥᏍᎪᎢ	Habitual	ᎦᏃᎸᎥᏍᎦ:Wind blowing
ᏃᎸᎦ	Immediate	ᎦᏃᎸᎥᏍᎦ:Wind blowing
ᏃᎸᏅᎢ	RemotePast	ᎦᏃᎸᎥᏍᎦ:Wind blowing
ᏃᎸᏍᏗ	Deverbal	ᎦᏃᎵ:Sneaking up on
ᏃᎸᏗ	Deverbal	ᎦᏃᎸᎥᏍᎦ:Wind blowing
ᏃᏄ	Other	ᏃᏄ:Hemlock
ᏃᏈᏏ	Other	ᏃᏈᏏ:Meadowlark
ᏃᏍᎦ	Immediate	ᎦᏃᏍᎩᎠ:Stealing
ᏃᏍᎩᎠ	PresentContinous	ᎦᏃᏍᎩᎠ:Stealing
ᏃᏍᎩᎢᏍᎪᎢ	Habitual	ᎦᏃᏍᎩᎠ:Stealing
ᏃᏍᎩᏍᏗ	Deverbal	ᎦᏃᏍᎩᎠ:Stealing
ᏃᏍᎩᏒᎢ	RemotePast	ᎦᏃᏍᎩᎠ:Stealing
ᏃᏓᏥ	Other	ᏃᏓᏥ:Spicewood
ᏃᏗ	Other	ᏃᏗ:Now
ᏃᏥ	Other	ᏃᏥ:Pine (all varieties)
ᏃᏯ	Other	ᏃᏯ:Sand
ᏃᏯᎭ	Other	ᏃᏯᎭ:Sandy
ᏃᏴᎢᏍᏗ	Deverbal	ᎦᏃᏴᎦ:Sinking
ᏃᏴᎦ	Immediate	ᎦᏃᏴᎦ:Sinking
ᏃᏴᎪᎢ	Habitual	ᎦᏃᏴᎦ:Sinking
ᏃᏴᎮᏍᏓ	Immediate	ᎦᏃᏴᎮᏍᏗᎭ:Ringing it (bell)
ᏃᏴᎮᏍᏓᏅᎢ	RemotePast	ᎦᏃᏴᎮᏍᏗᎭ:Ringing it (bell)
ᏃᏴᎮᏍᏗᎭ	PresentContinous	ᎦᏃᏴᎮᏍᏗᎭ:Ringing it (bell)
ᏃᏴᎮᏍᏗᏍᎪᎢ	Habitual	ᎦᏃᏴᎮᏍᏗᎭ:Ringing it (bell)
ᏃᏴᎮᏍᏙᏗ	Deverbal	ᎦᏃᏴᎮᏍᏗᎭ:Ringing it (bell)
ᏃᏴᏃᏴᎳ	Immediate	ᎤᏃᏴᏃᏴᎵᎦ:Making a noise
ᏃᏴᏃᏴᎵᎦ	PresentContinous	ᎤᏃᏴᏃᏴᎵᎦ:Making a noise
ᏃᏴᏃᏴᎵᎪᎢ	Habitual	ᎤᏃᏴᏃᏴᎵᎦ:Making a noise
ᏃᏴᏃᏴᎵᏍᏗ	Deverbal	ᎤᏃᏴᏃᏴᎵᎦ:Making a noise
ᏃᏴᏃᏴᎵᏒᎢ	RemotePast	ᎤᏃᏴᏃᏴᎵᎦ:Making a noise
ᏃᏴᏨᎢ	RemotePast	ᎦᏃᏴᎦ:Sinking
ᏄᎦ	Immediate	ᎧᏂ:Bringing something alive	ᏓᏁᎦ:Placing solid things in a row	ᏕᎦᏂ:Carrying something long	ᎦᏁᎧ:Carrying something flexible
ᏄᎦᎵ	Other	ᏄᎦᎵ:Genus: Rubus Sp
ᏄᎦᎸ	Other	ᏄᎦᎸ:Sawbrier
ᏄᎩᏣᏗ	Deverbal	ᎠᏂᎤᎩᏣᏍᎦ:Hugging
ᏄᎩᏨᏅᎢ	RemotePast	ᎠᏂᎤᎩᏣᏍᎦ:Hugging
ᏄᎪᎠ	Immediate	ᎦᏄᎪᎦ:Going out of it
ᏄᎪᎢᏍᏗ	Deverbal	ᎦᏄᎪᎦ:Going out of it
ᏄᎪᎣᎠ	Immediate	ᎦᏄᎪᎣᏍᎦ:Falling (multiple falls)
ᏄᎪᎣᏍᎦ	PresentContinous	ᎦᏄᎪᎣᏍᎦ:Falling (multiple falls)
ᏄᎪᎣᏍᎪᎢ	Habitual	ᎦᏄᎪᎣᏍᎦ:Falling (multiple falls)
ᏄᎪᎣᏒᎢ	RemotePast	ᎦᏄᎪᎣᏍᎦ:Falling (multiple falls)
ᏄᎪᎦ	PresentContinous	ᎦᏄᎪᎦ:Going out of it
ᏄᎪᎪᎢ	Habitual	ᎦᏄᎪᎦ:Going out of it
ᏄᎪᎯᏍᏗ	Deverbal	ᎦᏄᎪᎣᏍᎦ:Falling (multiple falls)
ᏄᎪᏨᎢ	RemotePast	ᎦᏄᎪᎦ:Going out of it
ᏄᎮᏒᎢ	RemotePast	ᎧᏄᎯ:Floating
ᏄᎯ	PresentContinous	ᎧᏄᎯ:Floating
ᏄᎯᏐᎢ	Habitual	ᎧᏄᎯ:Floating
ᏄᎰᎦ	Immediate	ᎧᏄᎯ:Floating
ᏄᎲᏍᏗ	Deverbal	ᎧᏄᎯ:Floating
ᏄᎲᏓ	Immediate	ᎧᏄᎲᏗᎭ:Floating it
ᏄᎲᏔᏅᎢ	RemotePast	ᎧᏄᎲᏗᎭ:Floating it
ᏄᎲᏗᎭ	PresentContinous	ᎧᏄᎲᏗᎭ:Floating it
ᏄᎲᏗᏍᎪᎢ	Habitual	ᎧᏄᎲᏗᎭ:Floating it
ᏄᎲᏙᏗ	Deverbal	ᎧᏄᎲᏗᎭ:Floating it
ᏄᎳᎦᏓ	PresentContinous	ᏕᎦᏄᎳᎦᏓ:Shucking corn
ᏄᎳᎦᏔ	Immediate	ᏕᎦᏄᎳᎦᏓ:Shucking corn
ᏄᎳᎦᏗᏍᎪᎢ	Habitual	ᏕᎦᏄᎳᎦᏓ:Shucking corn
ᏄᎳᎦᏗᏍᏗ	Deverbal	ᏕᎦᏄᎳᎦᏓ:Shucking corn
ᏄᎳᎦᏨᎢ	RemotePast	ᏕᎦᏄᎳᎦᏓ:Shucking corn
ᏄᎳᏌᎠ	PresentContinous	ᎦᏄᎳᏌᎠ:Covered with dirt
ᏄᎳᏌᎣᎢ	Habitual	ᎦᏄᎳᏌᎠ:Covered with dirt
ᏄᎳᏌᎲᎦ	Immediate	ᎦᏄᎳᏌᎠ:Covered with dirt
ᏄᎳᏒᎥᎦ	Immediate	ᎦᏄᎳᏒᎥᏍᎦ:Covering it with dirt
ᏄᎳᏒᎥᏍᎦ	PresentContinous	ᎦᏄᎳᏒᎥᏍᎦ:Covering it with dirt
ᏄᎳᏒᎥᏍᎪᎢ	Habitual	ᎦᏄᎳᏒᎥᏍᎦ:Covering it with dirt
ᏄᎳᏒᏂᎥᎢ	RemotePast	ᎦᏄᎳᏒᎥᏍᎦ:Covering it with dirt
ᏄᎳᏒᏅᎢ	RemotePast	ᎦᏄᎳᏌᎠ:Covered with dirt
ᏄᎳᏒᏗ	Deverbal	ᎦᏄᎳᏌᎠ:Covered with dirt
ᏄᎳᏒᏱ	Deverbal	ᎦᏄᎳᏒᎥᏍᎦ:Covering it with dirt
ᏄᎸᎲᎦ	Immediate	ᎤᏄᎸᎲᏍᎦ:Unable to do it
ᏄᎸᎲᏍᎦ	PresentContinous	ᎤᏄᎸᎲᏍᎦ:Unable to do it
ᏄᎸᎲᏍᎪᎢ	Habitual	ᎤᏄᎸᎲᏍᎦ:Unable to do it
ᏄᎸᏅᎢ	RemotePast	ᎤᏄᎸᎲᏍᎦ:Unable to do it
ᏄᎸᏗ	Deverbal	ᎤᏄᎸᎲᏍᎦ:Unable to do it
ᏄᎾ	Other	ᏄᎾ:Potato(es)
ᏄᏓᎴᎯ	Other	ᏄᏓᎴᎯ:Other one
ᏄᏖᏲᎧ	Immediate	ᎦᏄᏖᏲᎭ:Twisting it
ᏄᏖᏲᎭ	PresentContinous	ᎦᏄᏖᏲᎭ:Twisting it
ᏄᏖᏲᎸᎢ	RemotePast	ᎦᏄᏖᏲᎭ:Twisting it
ᏄᏖᏲᏍᎪᎢ	Habitual	ᎦᏄᏖᏲᎭ:Twisting it
ᏄᏖᏲᏍᏗ	Deverbal	ᎦᏄᏖᏲᎭ:Twisting it
ᏄᏯᎩ	Other	ᏄᏯᎩ:New York
ᏅᎠ	PresentContinous	ᎧᏅᎠ:Pushing aside
ᏅᎡᎭ	PresentContinous	ᎠᏅᎡᎭ:Taking something flexible or something solid to him
ᏅᎡᎰᎢ	Habitual	ᎠᏅᎡᎭ:Taking something flexible or something solid to him
ᏅᎡᎸᎢ	RemotePast	ᎠᏅᎡᎭ:Taking something flexible or something solid to him
ᏅᎡᏗ	Deverbal	ᎠᏅᎡᎭ:Taking something flexible or something solid to him
ᏅᎢ	RemotePast	ᎠᎥᏍᎦ:Placing something solid on the ground	ᎠᎲᏍᎦ:Laying down something solid
ᏅᎢᏍᏗ	Deverbal	ᎦᏅᎦ:Falling to the ground
ᏅᎥᎦ	Immediate	ᎦᏅᎥᏍᎦ:Placing something flexible or something alive on the ground
ᏅᎥᏌ	Immediate	ᎦᏅᏁᎭ:Giving something flexible to him
ᏅᎥᏍᎦ	PresentContinous	ᎦᏅᎥᏍᎦ:Placing something flexible or something alive on the ground
ᏅᎥᏍᎪᎢ	Habitual	ᎦᏅᎥᏍᎦ:Placing something flexible or something alive on the ground
ᏅᎥᏍᏔ	Immediate	ᎠᏅᎡᎭ:Taking something flexible or something solid to him
ᏅᎥᏍᏗ	Deverbal	ᎦᏅᏍᎦ:Delegating to him
ᏅᎦ	PresentContinous	ᎦᏅᎦ:Falling to the ground
ᏅᎦᎳ	Immediate	ᎦᏅᎦᎵᎠ:Cleaning (1)	ᎦᏅᎦᎵᎭ:Cleaning (2)
ᏅᎦᎵᎠ	PresentContinous	ᎦᏅᎦᎵᎠ:Cleaning (1)
ᏅᎦᎵᎭ	PresentContinous	ᎦᏅᎦᎵᎭ:Cleaning (2)
ᏅᎦᎵᏍᎪᎢ	Habitual	ᎦᏅᎦᎵᎭ:Cleaning (2)	ᎦᏅᎦᎵᎠ:Cleaning (1)
ᏅᎦᎵᏗ	Deverbal	ᎦᏅᎦᎵᎠ:Cleaning (1)	ᎦᏅᎦᎵᎭ:Cleaning (2)
ᏅᎦᎸᎥᎢ	RemotePast	ᎦᏅᎦᎵᎠ:Cleaning (1)
ᏅᎦᎸᎲᎢ	RemotePast	ᎦᏅᎦᎵᎭ:Cleaning (2)
ᏅᎦᏚᎯ	Other	ᏅᎦᏚᎯ:Fourteen
ᏅᎩ	Other	ᏅᎩ:Four
ᏅᎩᏍᎪᎯ	Other	ᏅᎩᏍᎪᎯ:Forty
ᏅᎪᎢ	Habitual	ᎦᏅᎦ:Falling to the ground
ᏅᎱᎦᎦ	Immediate	ᎦᏅᎱᎩᎠ:Flooding
ᏅᎱᎦᏅᎢ	RemotePast	ᎦᏅᎱᎩᎠ:Flooding
ᏅᎱᎩᎠ	PresentContinous	ᎦᏅᎱᎩᎠ:Flooding
ᏅᎱᎩᏍᎪᎢ	Habitual	ᎦᏅᎱᎩᎠ:Flooding
ᏅᎱᎪᏗ	Deverbal	ᎦᏅᎱᎩᎠ:Flooding
ᏅᎳ	Immediate	ᎦᏅᏍᎦ:Delegating to him
ᏅᎾ	Immediate	ᎧᏅᎠ:Pushing aside
ᏅᏁᎥᏍᏗ	Deverbal	ᏓᏅᏁᎦ:Placing flexible things into a row
ᏅᏁᎦ	PresentContinous	ᏓᏅᏁᎦ:Placing flexible things into a row
ᏅᏁᎪᎢ	Habitual	ᏓᏅᏁᎦ:Placing flexible things into a row
ᏅᏁᎭ	PresentContinous	ᎦᏅᏁᎭ:Giving something flexible to him
ᏅᏁᎰᎢ	Habitual	ᎦᏅᏁᎭ:Giving something flexible to him
ᏅᏁᎸᎢ	RemotePast	ᎦᏅᏁᎭ:Giving something flexible to him
ᏅᏁᏒᎢ	RemotePast	ᏓᏅᏁᎦ:Placing flexible things into a row
ᏅᏁᏗ	Deverbal	ᎦᏅᏁᎭ:Giving something flexible to him
ᏅᏃᎯ	Other	ᏅᏃᎯ:Road
ᏅᏄᎦ	Immediate	ᏓᏅᏁᎦ:Placing flexible things into a row
ᏅᏅᎢ	RemotePast	ᎦᏅᎥᏍᎦ:Placing something flexible or something alive on the ground	ᎦᎾᎠ:Lying down
ᏅᏆᎶᎠ	PresentContinous	ᎦᏅᏆᎶᎠ:Beating it
ᏅᏆᎶᎥᎢ	RemotePast	ᎦᏅᏆᎶᎠ:Beating it
ᏅᏆᎶᏍᎪᎢ	Habitual	ᎦᏅᏆᎶᎠ:Beating it
ᏅᏆᎶᏍᏗ	Deverbal	ᎦᏅᏆᎶᎠ:Beating it
ᏅᏆᎶᏣ	Immediate	ᎦᏅᏆᎶᎠ:Beating it
ᏅᏌᎣᏗ	Deverbal	ᎦᏅᏌᎲᏍᎦ:Stealing from him
ᏅᏌᎲᎦ	Immediate	ᎦᏅᏌᎲᏍᎦ:Stealing from him
ᏅᏌᎲᏍᎦ	PresentContinous	ᎦᏅᏌᎲᏍᎦ:Stealing from him
ᏅᏌᎲᏍᎪᎢ	Habitual	ᎦᏅᏌᎲᏍᎦ:Stealing from him
ᏅᏌᏅᎢ	RemotePast	ᎦᏅᏌᎲᏍᎦ:Stealing from him
ᏅᏍᎦ	PresentContinous	ᎦᏅᏍᎦ:Delegating to him
ᏅᏍᎪᎢ	Habitual	ᎦᏅᏍᎦ:Delegating to him	ᎧᏅᎠ:Pushing aside
ᏅᏍᏓ	Immediate	ᎦᏅᏍᏗᎭ:Being carried by something long
ᏅᏍᏔᏅᎢ	RemotePast	ᎦᏅᏍᏗᎭ:Being carried by something long
ᏅᏍᏗ	Deverbal	ᎧᏅᎠ:Pushing aside	ᏕᎦᏂ:Carrying something long	ᎧᏂ:Bringing something alive	ᎦᏁᎧ:Carrying something flexible	ᎦᏁᎭ:Carrying something flexible
ᏅᏍᏗᎭ	PresentContinous	ᎦᏅᏍᏗᎭ:Being carried by something flexible or something alive
ᏅᏍᏗᏍᎪᎢ	Habitual	ᎦᏅᏍᏗᎭ:Being carried by something long
ᏅᏍᏙᏗ	Deverbal	ᎦᏅᏍᏗᎭ:Being carried by something long
ᏅᏐᎦ	Immediate	ᎦᏅᏐᎯᎭ:Tightening it
ᏅᏐᎧ	Immediate	ᎦᏅᏐᎮᎭ:Winding a clock
ᏅᏐᎮᎭ	PresentContinous	ᎦᏅᏐᎮᎭ:Winding a clock
ᏅᏐᎮᎰᎢ	Habitual	ᎦᏅᏐᎮᎭ:Winding a clock
ᏅᏐᎯᎭ	PresentContinous	ᎦᏅᏐᎯᎭ:Tightening it
ᏅᏐᎯᎰᎢ	Habitual	ᎦᏅᏐᎯᎭ:Tightening it
ᏅᏐᎸᎢ	RemotePast	ᎦᏅᏐᎮᎭ:Winding a clock	ᎦᏅᏐᎯᎭ:Tightening it
ᏅᏐᏍᏗ	Deverbal	ᎦᏅᏐᎯᎭ:Tightening it	ᎦᏅᏐᎮᎭ:Winding a clock
ᏅᏒᎢ	RemotePast	ᎧᏅᎠ:Pushing aside	ᎦᏅᏍᎦ:Delegating to him
ᏅᏓᏕᏆ	Other	ᏅᏓᏕᏆ:November
ᏅᏓᏗᎧᏂ	Other	ᏅᏓᏗᎧᏂ:Sunflower
ᏅᏗ	Deverbal	ᎦᏅᎥᏍᎦ:Placing something flexible or something alive on the ground	ᎦᎾᎠ:Lying down
ᏅᏙᏇᏯ	Other	ᏅᏙᏇᏯ:Sourwood
ᏅᏙᏗᏎᏍᏗ	Other	ᏅᏙᏗᏎᏍᏗ:Calendar
ᏅᏣᏛ	Other	ᏅᏣᏛ:Breast
ᏅᏨᎢ	RemotePast	ᎦᏅᎦ:Falling to the ground
ᏅᏩᎦ	Immediate	ᎧᏅᏫᎠ:Doctoring him
ᏅᏩᏅᎢ	RemotePast	ᎧᏅᏫᎠ:Doctoring him
ᏅᏩᏍᏓ	Immediate	ᎤᏅᏩᏍᏗᎭ:Has chills
ᏅᏩᏍᏔᏅᎢ	RemotePast	ᎤᏅᏩᏍᏗᎭ:Has chills
ᏅᏩᏍᏗᎭ	PresentContinous	ᎤᏅᏩᏍᏗᎭ:Has chills
ᏅᏩᏍᏗᏍᎪᎢ	Habitual	ᎤᏅᏩᏍᏗᎭ:Has chills
ᏅᏩᏍᏙᏗ	Deverbal	ᎤᏅᏩᏍᏗᎭ:Has chills
ᏅᏫᎠ	PresentContinous	ᎧᏅᏫᎠ:Doctoring him
ᏅᏫᏍᎪᎢ	Habitual	ᎧᏅᏫᎠ:Doctoring him
ᏅᏫᏍᏓ	Immediate	ᎦᏅᏫᏍᏗᎭ:Urging him
ᏅᏫᏍᏓᏅᎢ	RemotePast	ᎦᏅᏫᏍᏗᎭ:Urging him
ᏅᏫᏍᏗᎭ	PresentContinous	ᎦᏅᏫᏍᏗᎭ:Urging him
ᏅᏫᏍᏗᏍᎪᎢ	Habitual	ᎦᏅᏫᏍᏗᎭ:Urging him
ᏅᏫᏍᏙᏗ	Deverbal	ᎦᏅᏫᏍᏗᎭ:Urging him
ᏅᏬᎢᏍᏗ	Deverbal	ᎦᏅᏬᎦ:Getting shallow
ᏅᏬᎦ	PresentContinous	ᎦᏅᏬᎦ:Getting shallow	ᎦᏅᏬᏍᎦ:Receding
ᏅᏬᎪᎢ	Habitual	ᎦᏅᏬᎦ:Getting shallow
ᏅᏬᎯᏍᏗ	Deverbal	ᎦᏅᏬᏍᎦ:Receding
ᏅᏬᏍᎦ	PresentContinous	ᎦᏅᏬᏍᎦ:Receding
ᏅᏬᏍᎪᎢ	Habitual	ᎦᏅᏬᏍᎦ:Receding
ᏅᏬᏒᎢ	RemotePast	ᎦᏅᏬᏍᎦ:Receding
ᏅᏬᏓ	Immediate	ᎦᏅᏬᏗᎭ:Making it shallow
ᏅᏬᏗ	Deverbal	ᎧᏅᏫᎠ:Doctoring him	ᏅᏬᏗ:Medicine
ᏅᏬᏗᎭ	PresentContinous	ᎦᏅᏬᏗᎭ:Making it shallow
ᏅᏬᏗᏍᎪᎢ	Habitual	ᎦᏅᏬᏗᎭ:Making it shallow
ᏅᏬᏗᏍᏗ	Deverbal	ᎦᏅᏬᏗᎭ:Making it shallow
ᏅᏬᏛᎢ	RemotePast	ᎦᏅᏬᏗᎭ:Making it shallow
ᏅᏬᏨᎢ	RemotePast	ᎦᏅᏬᎦ:Getting shallow
ᏅᏯ	Other	ᏅᏯ:Rock
ᏅᏲᎯ	Other	ᏅᏲᎯ:Rocky
ᏆᎳᎩᎠ	PresentContinous	ᏓᏆᎳᎩᎠ:Snoring
ᏆᎳᎩᏍᎪᎢ	Habitual	ᏓᏆᎳᎩᎠ:Snoring
ᏆᎳᎩᏍᏗ	Deverbal	ᏓᏆᎳᎩᎠ:Snoring
ᏆᎳᎩᏒᎢ	RemotePast	ᏓᏆᎳᎩᎠ:Snoring
ᏆᎳᎩᏣ	Immediate	ᏓᏆᎳᎩᎠ:Snoring
ᏆᎶᎦ	Other	ᏆᎶᎦ:Sumac
ᏆᎷᏏ	Other	ᏆᎷᏏ:Muscadine grapes
ᏆᎾ	Other	ᏆᎾ:Peaches
ᏆᎾᏗᏯ	Other	ᏆᎾᏗᏯ:Stretch mouth snake
ᏆᎾᏲᎭᎦ	Immediate	ᎠᏆᎾᏲᎯᎭ:Playing cards
ᏆᎾᏲᎯᎭ	PresentContinous	ᎠᏆᎾᏲᎯᎭ:Playing cards
ᏆᎾᏲᎯᎰᎢ	Habitual	ᎠᏆᎾᏲᎯᎭ:Playing cards
ᏆᎾᏲᎸᎢ	RemotePast	ᎠᏆᎾᏲᎯᎭ:Playing cards
ᏆᎾᏲᏍᏗ	Deverbal	ᎠᏆᎾᏲᎯᎭ:Playing cards
ᏆᏄᎾᏍᏗᎢ	Other	ᏆᏄᎾᏍᏗᎢ:Plum
ᏆᏲᎯᎭ	PresentContinous	ᎠᏆᏲᎯᎭ:Flipping with finger
ᏆᏲᎯᎰᎢ	Habitual	ᎠᏆᏲᎯᎭ:Flipping with finger
ᏆᏲᎸᎢ	RemotePast	ᎠᏆᏲᎯᎭ:Flipping with finger
ᏆᏲᏍᏗ	Deverbal	ᎠᏆᏲᎯᎭ:Flipping with finger
ᏇᏄᎦ	Immediate	ᎠᏇᏄᎩᎠ:Pinching
ᏇᏄᎩᎠ	PresentContinous	ᎠᏇᏄᎩᎠ:Pinching
ᏇᏄᎩᏍᎪᎢ	Habitual	ᎠᏇᏄᎩᎠ:Pinching
ᏇᏄᎩᏍᏗ	Deverbal	ᎠᏇᏄᎩᎠ:Pinching
ᏇᏄᎩᏒᎢ	RemotePast	ᎠᏇᏄᎩᎠ:Pinching
ᏈᏴᎡᎭ	PresentContinous	ᎠᏈᏴᎡᎭ:Paying him
ᏈᏴᎡᎰᎢ	Habitual	ᎠᏈᏴᎡᎭ:Paying him
ᏈᏴᎡᎸᎢ	RemotePast	ᎠᏈᏴᎡᎭ:Paying him
ᏈᏴᎡᏗ	Deverbal	ᎠᏈᏴᎡᎭ:Paying him
Ꮜ	Immediate	ᎠᏏᎭ:Removing from a shelf
ᏌᎣᏗ	Deverbal	ᎠᏌᎲᏍᎦ:Putting something solid up
ᏌᎦ	Immediate	ᎠᏌᎩᎠ:Removing something solid from a shelf
ᏌᎧ	Other	ᏌᎧ:Lightweight
ᏌᎧᎠ	PresentContinous	ᎠᏌᎧᎠ:Lightweight
ᏌᎧᎮᏍᏔ	Immediate	ᎠᏌᎧᎠ:Lightweight
ᏌᎧᎮᏍᏛᎢ	RemotePast	ᎠᏌᎧᎠ:Lightweight
ᏌᎧᎰᎢ	Habitual	ᎠᏌᎧᎠ:Lightweight
ᏌᎩᎠ	PresentContinous	ᎠᏌᎩᎠ:Removing something solid from a shelf
ᏌᎩᏍᎪᎢ	Habitual	ᎠᏌᎩᎠ:Removing something solid from a shelf
ᏌᎩᏍᏗ	Deverbal	ᎠᏌᎩᎠ:Removing something solid from a shelf
ᏌᎩᏏᏓ	Immediate	ᎠᏌᎩᏏᏙᎠ:Subtracting
ᏌᎩᏏᏙᎠ	PresentContinous	ᎠᏌᎩᏏᏙᎠ:Subtracting
ᏌᎩᏏᏙᎠᏍᏗ	Deverbal	ᎠᏌᎩᏏᏙᎠ:Subtracting
ᏌᎩᏏᏙᎰᎢ	Habitual	ᎠᏌᎩᏏᏙᎠ:Subtracting
ᏌᎩᏏᏙᎸᎢ	RemotePast	ᎠᏌᎩᏏᏙᎠ:Subtracting
ᏌᎩᏒᎢ	RemotePast	ᎠᏌᎩᎠ:Removing something solid from a shelf
ᏌᎪᏂᎨᎢ	Other	ᏌᎪᏂᎨᎢ:Blue
ᏌᎪᏗ	Deverbal	ᎠᏌᎧᎠ:Lightweight
ᏌᎲᎠ	PresentContinous	ᎠᏌᎲᎠ:Pushing something solid aside
ᏌᎲᎥᏍᎪᎢ	Habitual	ᎠᏌᎲᎠ:Pushing something solid aside
ᏌᎲᎦ	Immediate	ᎠᏌᎲᏍᎦ:Putting something solid up
ᏌᎲᎾ	Immediate	ᎠᏌᎲᎠ:Pushing something solid aside
ᏌᎲᏍᎦ	PresentContinous	ᎠᏌᎲᏍᎦ:Putting something solid up
ᏌᎲᏍᎪᎢ	Habitual	ᎠᏌᎲᏍᎦ:Putting something solid up
ᏌᎲᏍᏗ	Deverbal	ᎠᏌᎲᎠ:Pushing something solid aside
ᏌᎲᏒᎢ	RemotePast	ᎠᏌᎲᎠ:Pushing something solid aside
ᏌᎳᏓ	PresentContinous	ᎠᏌᎳᏓ:Raising it
ᏌᎳᏓᎦ	Immediate	ᎠᏌᎳᏓ:Raising it
ᏌᎳᏓᏅᎢ	RemotePast	ᎠᏌᎳᏗᎠ:Lifting
ᏌᎳᏓᏍᎪᎢ	Habitual	ᎠᏌᎳᏓ:Raising it
ᏌᎳᏗᎠ	PresentContinous	ᎠᏌᎳᏗᎠ:Lifting
ᏌᎳᏗᎦ	Immediate	ᎠᏌᎳᏗᎠ:Lifting
ᏌᎳᏗᏍᎪᎢ	Habitual	ᎠᏌᎳᏗᎠ:Lifting
ᏌᎳᏙᏗ	Deverbal	ᎠᏌᎳᏓ:Raising it	ᎠᏌᎳᏗᎠ:Lifting
ᏌᎳᏛᎢ	RemotePast	ᎠᏌᎳᏓ:Raising it
ᏌᎵ	Other	ᏌᎵ:Persimmon
ᏌᎵᎫᎩ	Other	ᏌᎵᎫᎩ:Snapping turtle
ᏌᎶᎵ	Other	ᏌᎶᎵ:Squirrel
ᏌᎷᏱ	Other	ᏌᎷᏱ:Thicket
ᏌᎾᏩ	Other	ᏌᎾᏩ:Pigeon hawk
ᏌᏁᏅᏛᎥᎦ	Immediate	ᎦᏌᏁᏅᏛᎥᏍᎦ:Threading a needle
ᏌᏁᏅᏛᎥᏍᎦ	PresentContinous	ᎦᏌᏁᏅᏛᎥᏍᎦ:Threading a needle
ᏌᏁᏅᏛᎥᏍᎪᎢ	Habitual	ᎦᏌᏁᏅᏛᎥᏍᎦ:Threading a needle
ᏌᏁᏅᏛᏅᎢ	RemotePast	ᎦᏌᏁᏅᏛᎥᏍᎦ:Threading a needle
ᏌᏁᏅᏛᏗ	Deverbal	ᎦᏌᏁᏅᏛᎥᏍᎦ:Threading a needle
ᏌᏂᏓ	Immediate	ᎠᏌᏂᏙᎭ:Adding
ᏌᏂᏙᎠᏍᏗ	Deverbal	ᎠᏌᏂᏙᎭ:Adding
ᏌᏂᏙᎭ	PresentContinous	ᎠᏌᏂᏙᎭ:Adding
ᏌᏂᏙᎰᎢ	Habitual	ᎠᏌᏂᏙᎭ:Adding
ᏌᏂᏙᎸᎢ	RemotePast	ᎠᏌᏂᏙᎭ:Adding
ᏌᏅᎢ	RemotePast	ᎠᏌᎲᏍᎦ:Putting something solid up
ᏌᏅᏬ	Other	ᏌᏅᏬ:Mythical hawk like bird
ᏌᏆᎴᎦ	Immediate	ᎠᏌᏆᎴᎭ:Rolling it	ᎠᏌᏆᎴᏍᎦ:Rolling it around
ᏌᏆᎴᎭ	PresentContinous	ᎠᏌᏆᎴᎭ:Rolling it
ᏌᏆᎴᎰᎢ	Habitual	ᎠᏌᏆᎴᎭ:Rolling it
ᏌᏆᎴᎴᏒᎢ	RemotePast	ᎠᏌᏆᎴᎵ:Rolling along
ᏌᏆᎴᎵ	PresentContinous	ᎠᏌᏆᎴᎵ:Rolling along
ᏌᏆᎴᎵᏐᎢ	Habitual	ᎠᏌᏆᎴᎵ:Rolling along
ᏌᏆᎴᎷᎦ	Immediate	ᎠᏌᏆᎴᎵ:Rolling along
ᏌᏆᎴᎸᎢ	RemotePast	ᎠᏌᏆᎴᎭ:Rolling it	ᎠᏌᏆᎴᏍᎦ:Rolling it around
ᏌᏆᎴᎸᏍᏗ	Deverbal	ᎠᏌᏆᎴᎵ:Rolling along
ᏌᏆᎴᏍᎦ	PresentContinous	ᎠᏌᏆᎴᏍᎦ:Rolling it around
ᏌᏆᎴᏍᎪᎢ	Habitual	ᎠᏌᏆᎴᏍᎦ:Rolling it around
ᏌᏆᎴᏍᏗ	Deverbal	ᎠᏌᏆᎴᎭ:Rolling it
ᏌᏆᎴᏗ	Deverbal	ᎠᏌᏆᎴᏍᎦ:Rolling it around
ᏌᏌ	Other	ᏌᏌ:Goose
ᏌᏓ	Immediate	ᎠᏌᏗᎠ:Putting something long up
ᏌᏗᎠ	PresentContinous	ᎠᏌᏗᎠ:Putting something long up
ᏌᏗᏍᎪᎢ	Habitual	ᎠᏌᏗᎠ:Putting something long up
ᏌᏗᏍᏗ	Deverbal	ᎠᏌᏗᎠ:Putting something long up
ᏌᏙᎥᏓ	Immediate	ᎠᏌᏙᎥᏗᎭ:Knocking over a stack of objects
ᏌᏙᎥᏔᏅᎢ	RemotePast	ᎠᏌᏙᎥᏗᎭ:Knocking over a stack of objects
ᏌᏙᎥᏗᎭ	PresentContinous	ᎠᏌᏙᎥᏗᎭ:Knocking over a stack of objects
ᏌᏙᎥᏗᏍᎪᎢ	Habitual	ᎠᏌᏙᎥᏗᎭ:Knocking over a stack of objects
ᏌᏙᎥᏙᏗ	Deverbal	ᎠᏌᏙᎥᏗᎭ:Knocking over a stack of objects
ᏌᏙᏯᎭ	Immediate	ᎠᏌᏙᏯᏍᎦ:Pushing it
ᏌᏙᏯᎲᎢ	RemotePast	ᎠᏌᏙᏯᏍᎦ:Pushing it
ᏌᏙᏯᏍᎦ	PresentContinous	ᎠᏌᏙᏯᏍᎦ:Pushing it
ᏌᏙᏯᏍᎪᎢ	Habitual	ᎠᏌᏙᏯᏍᎦ:Pushing it
ᏌᏙᏯᏍᏗ	Deverbal	ᎠᏌᏙᏯᏍᎦ:Pushing it
ᏌᏛᎢ	RemotePast	ᎠᏌᏗᎠ:Putting something long up
ᏌᏛᎥᎦ	Immediate	ᎠᏌᏛᎥᏍᎦ:Trapping
ᏌᏛᎥᏍᎦ	PresentContinous	ᎠᏌᏛᎥᏍᎦ:Trapping
ᏌᏛᎥᏍᎪᎢ	Habitual	ᎠᏌᏛᎥᏍᎦ:Trapping
ᏌᏛᏅᎢ	RemotePast	ᎠᏌᏛᎥᏍᎦ:Trapping
ᏌᏛᏗ	Deverbal	ᎠᏌᏛᎥᏍᎦ:Trapping
ᏍᎦᎢᎭ	PresentContinous	ᎠᏍᎦᎢᎭ:Afraid of
ᏍᎦᎢᎰᎢ	Habitual	ᎠᏍᎦᎢᎭ:Afraid of
ᏍᎦᎳ	Immediate	ᎠᏍᎦᎵᎦ:Biting it
ᏍᎦᎵᎦ	PresentContinous	ᎠᏍᎦᎵᎦ:Biting it
ᏍᎦᎵᎪᎢ	Habitual	ᎠᏍᎦᎵᎦ:Biting it
ᏍᎦᎵᏍᏗ	Deverbal	ᎠᏍᎦᎵᎦ:Biting it
ᏍᎦᎵᏨᎢ	RemotePast	ᎠᏍᎦᎵᎦ:Biting it
ᏍᎦᎸᎢ	RemotePast	ᎠᏍᎦᎢᎭ:Afraid of
ᏍᎦᏃᎳ	PresentContinous	ᎠᏍᎦᏃᎳ:Slow
ᏍᎦᏃᎳᏗᏍᏗ	Deverbal	ᎠᏍᎦᏃᎳ:Slow
ᏍᎦᏃᎳᏛᎢ	RemotePast	ᎠᏍᎦᏃᎳ:Slow
ᏍᎦᏃᎴᏍᏔ	Immediate	ᎠᏍᎦᏃᎳ:Slow
ᏍᎦᏃᎶᎢ	Habitual	ᎠᏍᎦᏃᎳ:Slow
ᏍᎦᏅᎢᏍᏗ	Deverbal	ᎠᏍᎦᏅᎦ:Misbehaving
ᏍᎦᏅᎦ	Immediate	ᎠᏍᎦᏅᎦ:Misbehaving
ᏍᎦᏅᎪᎢ	Habitual	ᎠᏍᎦᏅᎦ:Misbehaving
ᏍᎦᏅᏨᎢ	RemotePast	ᎠᏍᎦᏅᎦ:Misbehaving
ᏍᎦᏍᏗ	Deverbal	ᎠᏍᎦᎢᎭ:Afraid of
ᏍᎦᏎᏅ	Other	ᏍᎦᏎᏅ:Fearless
ᏍᎦᏯ	Immediate	ᎠᏍᎦᎢᎭ:Afraid of
ᏍᎦᏰᎬᏍᏗ	Other	ᏍᎦᏰᎬᏍᏗ:Manager
ᏍᎩ	Other	ᏍᎩ:Thanks
ᏍᎩᎦ	Other	ᏍᎩᎦ:That much
ᏍᎩᎾᏂ	Other	ᏍᎩᎾᏂ:That's the one
ᏍᎩᏈᏳᏍᏗ	Other	ᏍᎩᏈᏳᏍᏗ:Just like that
ᏍᎩᏊᏩᏌ	Other	ᏍᎩᏊᏩᏌ:Only thing
ᏍᎩᏕᎦ	Other	ᏍᎩᏕᎦ:That so?
ᏍᎪᎦ	Immediate	ᎠᏍᎪᎩᎠ:Gnawing
ᏍᎪᎩᎠ	PresentContinous	ᎠᏍᎪᎩᎠ:Gnawing
ᏍᎪᎩᏍᎪᎢ	Habitual	ᎠᏍᎪᎩᎠ:Gnawing
ᏍᎪᎩᏍᏗ	Deverbal	ᎠᏍᎪᎩᎠ:Gnawing
ᏍᎪᎬᎢ	RemotePast	ᎠᏍᎪᎩᎠ:Gnawing
ᏍᎪᎯ	Other	ᏍᎪᎯ:Ten
ᏍᎪᎯᏥᏆ	Other	ᏍᎪᎯᏥᏆ:One hundred
ᏍᎪᎸᎢᏍᏓ	Immediate	ᏓᏍᎪᎸᎢᏍᏗᎭ:Fading clothes
ᏍᎪᎸᎢᏍᏓᏅᎢ	RemotePast	ᏓᏍᎪᎸᎢᏍᏗᎭ:Fading clothes
ᏍᎪᎸᎢᏍᏗ	Deverbal	ᎠᏍᎪᎸᎦ:Fading
ᏍᎪᎸᎢᏍᏗᎭ	PresentContinous	ᏓᏍᎪᎸᎢᏍᏗᎭ:Fading clothes
ᏍᎪᎸᎢᏍᏗᏍᎪᎢ	Habitual	ᏓᏍᎪᎸᎢᏍᏗᎭ:Fading clothes
ᏍᎪᎸᎢᏍᏙᏗ	Deverbal	ᏓᏍᎪᎸᎢᏍᏗᎭ:Fading clothes
ᏍᎪᎸᎦ	Immediate	ᎠᏍᎪᎸᎦ:Fading
ᏍᎪᎸᎪᎢ	Habitual	ᎠᏍᎪᎸᎦ:Fading
ᏍᎪᎸᏨᎢ	RemotePast	ᎠᏍᎪᎸᎦ:Fading
ᏍᎪᏂᏎᎾᏏ	Other	ᏍᎪᏂᏎᎾᏏ:Dime
ᏍᎫᏓᎦ	Immediate	ᎠᏍᎫᏓᎩᎠ:Cutting off a head (cabbage)
ᏍᎫᏓᎩᎠ	PresentContinous	ᎠᏍᎫᏓᎩᎠ:Cutting off a head (cabbage)
ᏍᎫᏓᎩᏍᎪᎢ	Habitual	ᎠᏍᎫᏓᎩᎠ:Cutting off a head (cabbage)
ᏍᎫᏓᎩᏍᏗ	Deverbal	ᎠᏍᎫᏓᎩᎠ:Cutting off a head (cabbage)
ᏍᎫᏓᎩᏒᎢ	RemotePast	ᎠᏍᎫᏓᎩᎠ:Cutting off a head (cabbage)
ᏍᎫᏩᏓ	Immediate	ᎤᏍᎫᏩᏗᎠ:Has a headache
ᏍᎫᏩᏗᎠ	PresentContinous	ᎤᏍᎫᏩᏗᎠ:Has a headache
ᏍᎫᏩᏗᏍᎪᎢ	Habitual	ᎤᏍᎫᏩᏗᎠ:Has a headache
ᏍᎫᏩᏗᏍᏗ	Deverbal	ᎤᏍᎫᏩᏗᎠ:Has a headache
ᏍᎫᏩᏛᎢ	RemotePast	ᎤᏍᎫᏩᏗᎠ:Has a headache
ᏍᏂᏙᎳᏛᎢ	Other	ᏍᏂᏙᎳᏛᎢ:Cook stove
ᏍᏆᎳᎦ	Immediate	ᎠᏍᏆᎵᏍᎦ:Breaking something long
ᏍᏆᎳᎯ	Other	ᏍᏆᎳᎯ:Short
ᏍᏆᎵᏍᎦ	PresentContinous	ᎠᏍᏆᎵᏍᎦ:Breaking something long
ᏍᏆᎵᏍᎪᎢ	Habitual	ᎠᏍᏆᎵᏍᎦ:Breaking something long
ᏍᏆᎵᏍᏗ	Deverbal	ᎠᏍᏆᎵᏍᎦ:Cutting something long off
ᏍᏆᎵᏒᎢ	RemotePast	ᎠᏍᏆᎵᏍᎦ:Breaking something long
ᏍᏆᎵᏓ	Immediate	ᏓᏍᏆᎵᏗᎭ:Running
ᏍᏆᎵᏔᏅᎢ	RemotePast	ᏓᏍᏆᎵᏗᎭ:Running
ᏍᏆᎵᏗᎭ	PresentContinous	ᏓᏍᏆᎵᏗᎭ:Running
ᏍᏆᎵᏗᏍᎪᎢ	Habitual	ᏓᏍᏆᎵᏗᎭ:Running
ᏍᏆᎵᏙᏗ	Deverbal	ᏓᏍᏆᎵᏗᎭ:Running
ᏍᏆᎶᎠ	PresentContinous	ᎠᏍᏆᎶᎠ:Bumping someone's head
ᏍᏆᎶᎥᎢ	RemotePast	ᎠᏍᏆᎶᎠ:Bumping someone's head
ᏍᏆᎶᏍᎪᎢ	Habitual	ᎠᏍᏆᎶᎠ:Bumping someone's head
ᏍᏆᎶᏍᏗ	Deverbal	ᎠᏍᏆᎶᎠ:Bumping someone's head
ᏍᏆᎶᏣ	Immediate	ᎠᏍᏆᎶᎠ:Bumping someone's head
ᏍᏆᎸᎢᎭ	PresentContinous	ᎠᏍᏆᎸᎢᎭ:Hitting someone in the head with something long
ᏍᏆᎸᎢᎰᎢ	Habitual	ᎠᏍᏆᎸᎢᎭ:Hitting someone in the head with something long
ᏍᏆᎸᎢᏍᏗ	Deverbal	ᎠᏍᏆᎸᎢᎭ:Hitting someone in the head with something long
ᏍᏆᎸᎦ	Immediate	ᎠᏍᏆᎸᎢᎭ:Hitting someone in the head with something long
ᏍᏆᎸᎸᎢ	RemotePast	ᎠᏍᏆᎸᎢᎭ:Hitting someone in the head with something long
ᏍᏆᏂᎪᎯᏍᏗ	Deverbal	ᎠᏍᏆᏂᎪᏍᎦ:Admiring
ᏍᏆᏂᎪᎳ	Immediate	ᎠᏍᏆᏂᎪᏍᎦ:Admiring
ᏍᏆᏂᎪᏍᎦ	PresentContinous	ᎠᏍᏆᏂᎪᏍᎦ:Admiring
ᏍᏆᏂᎪᏍᎪᎢ	Habitual	ᎠᏍᏆᏂᎪᏍᎦ:Admiring
ᏍᏆᏂᎪᏍᏗ	Deverbal	ᎠᏍᏆᏂᎪᏒᎥᏍᎦ:Amusing himself
ᏍᏆᏂᎪᏒᎢ	RemotePast	ᎠᏍᏆᏂᎪᏍᎦ:Admiring
ᏍᏆᏂᎪᏒᎥᎦ	Immediate	ᎠᏍᏆᏂᎪᏒᎥᏍᎦ:Amusing himself
ᏍᏆᏂᎪᏒᎥᏍᎦ	PresentContinous	ᎠᏍᏆᏂᎪᏒᎥᏍᎦ:Amusing himself
ᏍᏆᏂᎪᏒᎥᏍᎪᎢ	Habitual	ᎠᏍᏆᏂᎪᏒᎥᏍᎦ:Amusing himself
ᏍᏆᏂᎪᏒᏅᎢ	RemotePast	ᎠᏍᏆᏂᎪᏒᎥᏍᎦ:Amusing himself
ᏍᏆᏄᏣ	Immediate	ᎠᏍᏆᏄᏥᎦ:Sucking his thumb
ᏍᏆᏄᏥᎦ	PresentContinous	ᎠᏍᏆᏄᏥᎦ:Sucking his thumb
ᏍᏆᏄᏥᎪᎢ	Habitual	ᎠᏍᏆᏄᏥᎦ:Sucking his thumb
ᏍᏆᏄᏥᏗ	Deverbal	ᎠᏍᏆᏄᏥᎦ:Sucking his thumb
ᏍᏆᏄᏨᎢ	RemotePast	ᎠᏍᏆᏄᏥᎦ:Kissing (sucking)
ᏍᏆᏓ	Immediate	ᏓᏍᏆᏗᎠ:Graduating
ᏍᏆᏗᎠ	PresentContinous	ᏓᏍᏆᏗᎠ:Graduating
ᏍᏆᏗᏍᎪᎢ	Habitual	ᏓᏍᏆᏗᎠ:Graduating
ᏍᏆᏗᏍᏗ	Deverbal	ᏓᏍᏆᏗᎠ:Graduating
ᏍᏆᏛᎢ	RemotePast	ᏓᏍᏆᏗᎠ:Graduating
ᏍᏇᎵᏯ	Immediate	ᎠᏍᏇᎵᏰᎠ:Spelling
ᏍᏇᎵᏰᎠ	PresentContinous	ᎠᏍᏇᎵᏰᎠ:Spelling
ᏍᏇᎵᏰᎥᎢ	RemotePast	ᎠᏍᏇᎵᏰᎠ:Spelling
ᏍᏇᎵᏰᏍᎪᎢ	Habitual	ᎠᏍᏇᎵᏰᎠ:Spelling
ᏍᏇᎵᏰᏗ	Deverbal	ᎠᏍᏇᎵᏰᎠ:Spelling
ᏍᏉᎯᏍᏗ	Deverbal	ᎠᏍᏉᏍᎦ:Craving
ᏍᏉᎳ	Immediate	ᎠᏍᏉᏍᎦ:Craving
ᏍᏉᎳᏓ	Immediate	ᎤᏍᏉᎳᏗᎠ:Has diarrhea
ᏍᏉᎳᏗᎠ	PresentContinous	ᎤᏍᏉᎳᏗᎠ:Has diarrhea
ᏍᏉᎳᏗᏍᎪᎢ	Habitual	ᎤᏍᏉᎳᏗᎠ:Has diarrhea
ᏍᏉᎳᏗᏍᏗ	Deverbal	ᎤᏍᏉᎳᏗᎠ:Has diarrhea
ᏍᏉᎳᏛᎢ	RemotePast	ᎤᏍᏉᎳᏗᎠ:Has diarrhea
ᏍᏉᎵ	Other	ᏍᏉᎵ:Stomach
ᏍᏉᎸᎭ	Immediate	ᎦᏍᏉᎸᏍᎦ:Dripping
ᏍᏉᎸᏍᎦ	PresentContinous	ᎦᏍᏉᎸᏍᎦ:Dripping
ᏍᏉᎸᏍᎪᎢ	Habitual	ᎦᏍᏉᎸᏍᎦ:Dripping
ᏍᏉᎸᏍᏗ	Deverbal	ᎦᏍᏉᎸᏍᎦ:Dripping
ᏍᏉᎸᏒᎢ	RemotePast	ᎦᏍᏉᎸᏍᎦ:Dripping
ᏍᏉᏍᎦ	PresentContinous	ᎠᏍᏉᏍᎦ:Craving
ᏍᏉᏍᎪᎢ	Habitual	ᎠᏍᏉᏍᎦ:Craving
ᏍᏉᏒᎢ	RemotePast	ᎠᏍᏉᏍᎦ:Craving
ᏍᏓᏩᏕᏒᎢ	RemotePast	ᎠᏍᏓᏩᏗ:Following
ᏍᏓᏩᏗ	PresentContinous	ᎠᏍᏓᏩᏗ:Following
ᏍᏓᏩᏗᏐᎢ	Habitual	ᎠᏍᏓᏩᏗ:Following
ᏍᏓᏩᏚᎦ	Immediate	ᎠᏍᏓᏩᏗ:Following
ᏍᏓᏩᏛᏍᏗ	Deverbal	ᎠᏍᏓᏩᏗ:Following
ᏍᏓᏯ	Other	ᏍᏓᏯ:Hard
ᏍᏓᏱ	Other	ᏍᏓᏱ:Too hard
ᏍᏓᏱᏓ	Immediate	ᎠᏍᏓᏱᏗᎠ:Making fast
ᏍᏓᏱᏗᎠ	PresentContinous	ᎠᏍᏓᏱᏗᎠ:Strengthening
ᏍᏓᏱᏗᏍᎪᎢ	Habitual	ᎠᏍᏓᏱᏗᎠ:Strengthening
ᏍᏓᏱᏗᏍᏗ	Deverbal	ᎠᏍᏓᏱᏗᎠ:Making fast
ᏍᏓᏱᏛᎢ	RemotePast	ᎠᏍᏓᏱᏗᎠ:Strengthening
ᏍᏓᏴᎲᏍᎩ	Other	ᏍᏓᏴᎲᏍᎩ:Wife
ᏍᏕᎳ	Immediate	ᎠᏍᏕᎵᎭ:Helping
ᏍᏕᎵᎭ	PresentContinous	ᎠᏍᏕᎵᎭ:Helping
ᏍᏕᎵᏍᎪᎢ	Habitual	ᎠᏍᏕᎵᎭ:Helping
ᏍᏕᎵᏗ	Deverbal	ᎠᏍᏕᎵᎭ:Helping
ᏍᏕᎸᎲᎢ	RemotePast	ᎠᏍᏕᎵᎭ:Helping
ᏍᏕᏯᏗ	Other	ᏍᏕᏯᏗ:Rope
ᏍᏕᏲᏌ	Immediate	ᎠᏍᏕᏲᏎᎭ:Braiding hair
ᏍᏕᏲᏎᎭ	PresentContinous	ᎠᏍᏕᏲᏎᎭ:Braiding hair
ᏍᏕᏲᏎᎰᎢ	Habitual	ᎠᏍᏕᏲᏎᎭ:Braiding hair
ᏍᏕᏲᏎᎸᎢ	RemotePast	ᎠᏍᏕᏲᏎᎭ:Braiding hair
ᏍᏕᏲᏎᏗ	Deverbal	ᎠᏍᏕᏲᏎᎭ:Braiding hair
ᏍᏗᎦ	Immediate	ᎠᏍᏗᎩᎠ:Eating something long
ᏍᏗᎧᏓ	Other	ᏍᏗᎧᏓ:Just a little
ᏍᏗᎩᎠ	PresentContinous	ᎠᏍᏗᎩᎠ:Eating something long
ᏍᏗᎩᏍᎪᎢ	Habitual	ᎠᏍᏗᎩᎠ:Eating something long
ᏍᏗᎩᏍᏗ	Deverbal	ᎠᏍᏗᎩᎠ:Eating something long
ᏍᏗᎬᎢ	RemotePast	ᎠᏍᏗᎩᎠ:Eating something long
ᏍᏗᏭᎣᎭ	Immediate	ᎦᏍᏗᏭᎣᏍᎦ:Leaves are falling
ᏍᏗᏭᎣᎯᏍᏗ	Deverbal	ᎦᏍᏗᏭᎣᏍᎦ:Leaves are falling
ᏍᏗᏭᎣᏍᎦ	PresentContinous	ᎦᏍᏗᏭᎣᏍᎦ:Leaves are falling
ᏍᏗᏭᎣᏍᎪᎢ	Habitual	ᎦᏍᏗᏭᎣᏍᎦ:Leaves are falling
ᏍᏗᏭᎣᏒᎢ	RemotePast	ᎦᏍᏗᏭᎣᏍᎦ:Leaves are falling
ᏍᏗᏯᎯ	Other	ᏍᏗᏯᎯ:Sick
ᏍᏗᏰᎬᎢ	Other	ᏍᏗᏰᎬᎢ:Hair on the head
ᏍᏗᏰᏓ	Immediate	ᎠᏍᏗᏰᏗᎭ:Begging from him
ᏍᏗᏰᏔᏅᎢ	RemotePast	ᎠᏍᏗᏰᏗᎭ:Begging from him
ᏍᏗᏰᏗᎭ	PresentContinous	ᎠᏍᏗᏰᏗᎭ:Begging from him
ᏍᏗᏰᏗᏍᎪᎢ	Habitual	ᎠᏍᏗᏰᏗᎭ:Begging from him
ᏍᏗᏰᏙᏗ	Deverbal	ᎠᏍᏗᏰᏗᎭ:Begging from him
ᏍᏙᎠ	PresentContinous	ᎠᏍᏙᎠ:Pounding
ᏍᏙᎥᎢ	RemotePast	ᎠᏍᏙᎠ:Pounding
ᏍᏙᏍᎪᎢ	Habitual	ᎠᏍᏙᎠ:Pounding
ᏍᏙᏍᏗ	Deverbal	ᎠᏍᏙᎠ:Pounding	ᏍᏙᏍᏗ:Pestle
ᏍᏙᏣ	Immediate	ᎠᏍᏙᎠ:Pounding
ᏍᏙᏰᎠ	Immediate	ᎠᏍᏙᏰᎭ:Shaving him
ᏍᏙᏰᎭ	PresentContinous	ᎠᏍᏙᏰᎭ:Shaving him
ᏍᏙᏰᎲᎢ	RemotePast	ᎠᏍᏙᏰᎭ:Shaving him
ᏍᏙᏰᏍᎪᎢ	Habitual	ᎠᏍᏙᏰᎭ:Shaving him
ᏍᏙᏰᏗ	Deverbal	ᎠᏍᏙᏰᎭ:Shaving him
ᏍᏚᎦ	Immediate	ᎠᏍᏚᎩᎢᎠ:Opening a door
ᏍᏚᎩᎢᎠ	PresentContinous	ᎠᏍᏚᎩᎢᎠ:Opening a door
ᏍᏚᎩᎢᏍᎪᎢ	Habitual	ᎠᏍᏚᎩᎢᎠ:Opening a door
ᏍᏚᎩᏍᏗ	Other	ᏍᏚᎩᏍᏗ:Key
ᏍᏚᎩᏒᎢ	RemotePast	ᎠᏍᏚᎩᎢᎠ:Opening a door
ᏍᏚᎩᏗ	Deverbal	ᎠᏍᏚᎩᎢᎠ:Opening a door
ᏍᏚᎲᎦ	Immediate	ᎠᏍᏚᎲᏍᎦ:Shutting
ᏍᏚᎲᏍᎦ	PresentContinous	ᎠᏍᏚᎲᏍᎦ:Shutting
ᏍᏚᎲᏍᎪᎢ	Habitual	ᎠᏍᏚᎲᏍᎦ:Shutting
ᏍᏚᏅᎢ	RemotePast	ᎠᏍᏚᎲᏍᎦ:Shutting
ᏍᏚᏗ	Deverbal	ᎠᏍᏚᎲᏍᎦ:Shutting
ᏍᏚᏥᎠ	PresentContinous	ᎤᏍᏚᏥᎠ:Dripping
ᏍᏚᏥᏍᎪᎢ	Habitual	ᎤᏍᏚᏥᎠ:Dripping
ᏍᏚᏥᏍᏗ	Deverbal	ᎤᏍᏚᏥᎠ:Dripping
ᏍᏚᏥᏓ	Immediate	ᎠᏍᏚᏥᏙᎭ:Sprinkling
ᏍᏚᏥᏙᎭ	PresentContinous	ᎠᏍᏚᏥᏙᎭ:Sprinkling
ᏍᏚᏥᏙᎰᎢ	Habitual	ᎠᏍᏚᏥᏙᎭ:Sprinkling
ᏍᏚᏥᏙᎸᎢ	RemotePast	ᎠᏍᏚᏥᏙᎭ:Sprinkling
ᏍᏚᏥᏙᏗ	Deverbal	ᎠᏍᏚᏥᏙᎭ:Sprinkling
ᏍᏚᏥᏣ	Immediate	ᎤᏍᏚᏥᎠ:Dripping
ᏍᏚᏥᏨᎢ	RemotePast	ᎤᏍᏚᏥᎠ:Dripping
ᏍᏛᎦ	Immediate	ᎠᏍᏛᏍᎦ:Finishing
ᏍᏛᎪᎣᏍᏗ	Deverbal	ᎠᏍᏛᎪᏍᎦ:Scraping (grit corn)
ᏍᏛᎪᎳ	Immediate	ᎠᏍᏛᎪᏍᎦ:Scraping (grit corn)
ᏍᏛᎪᏍᎦ	PresentContinous	ᎠᏍᏛᎪᏍᎦ:Scraping (grit corn)
ᏍᏛᎪᏍᎪᎢ	Habitual	ᎠᏍᏛᎪᏍᎦ:Scraping (grit corn)
ᏍᏛᎪᏒᎢ	RemotePast	ᎠᏍᏛᎪᏍᎦ:Scraping (grit corn)
ᏍᏛᎯᏍᏓ	Immediate	ᎠᏍᏛᎯᏍᏗᎭ:Making it deep
ᏍᏛᎯᏍᏔᏅᎢ	RemotePast	ᎠᏍᏛᎯᏍᏗᎭ:Making it deep
ᏍᏛᎯᏍᏗᎭ	PresentContinous	ᎠᏍᏛᎯᏍᏗᎭ:Making it deep
ᏍᏛᎯᏍᏗᏍᎪᎢ	Habitual	ᎠᏍᏛᎯᏍᏗᎭ:Making it deep
ᏍᏛᎯᏍᏙᏗ	Deverbal	ᎠᏍᏛᎯᏍᏗᎭ:Making it deep
ᏍᏛᏁᎦᎳ	Immediate	ᎠᏍᏛᏁᎦᎵᎭ:Scalping him
ᏍᏛᏁᎦᎵᎭ	PresentContinous	ᎠᏍᏛᏁᎦᎵᎭ:Scalping him
ᏍᏛᏁᎦᎵᏍᎪᎢ	Habitual	ᎠᏍᏛᏁᎦᎵᎭ:Scalping him
ᏍᏛᏁᎦᎵᏗ	Deverbal	ᎠᏍᏛᏁᎦᎵᎭ:Scalping him
ᏍᏛᏁᎦᎸᎲᎢ	RemotePast	ᎠᏍᏛᏁᎦᎵᎭ:Scalping him
ᏍᏛᏅᎢ	RemotePast	ᎠᏍᏛᏍᎦ:Finishing
ᏍᏛᏍᎦ	PresentContinous	ᎠᏍᏛᏍᎦ:Finishing
ᏍᏛᏍᎪᎢ	Habitual	ᎠᏍᏛᏍᎦ:Finishing
ᏍᏛᏍᏗ	Deverbal	ᎠᏍᏛᏍᎦ:Finishing
ᏎᎦ	Other	ᏎᎦ:Little while
ᏎᎦᏨ	Other	ᏎᎦᏨ:Almost
ᏎᎮᎭ	PresentContinous	ᎠᏎᎮᎭ:Showing
ᏎᎮᎰᎢ	Habitual	ᎠᏎᎮᎭ:Showing
ᏎᎮᎸᎢ	RemotePast	ᎠᏎᎮᎭ:Showing
ᏎᎮᏍᏗ	Deverbal	ᎠᏎᎮᎭ:Showing
ᏎᎯᎭ	PresentContinous	ᎠᏎᎯᎭ:Pointing at him
ᏎᎯᎰᎢ	Habitual	ᎠᏎᎯᎭ:Pointing at him
ᏎᎵᎦᏍᏉ	Other	ᏎᎵᎦᏍᏉ:Muskrat
ᏎᎷ	Other	ᏎᎷ:Genus: Zea Mays
ᏎᎷᏉᏯ	Other	ᏎᎷᏉᏯ:Genus: Yucca Flaccida
ᏎᎷᏯᎯ	Other	ᏎᎷᏯᎯ:Flour corn
ᏎᎸᎢ	RemotePast	ᎠᏎᎯᎭ:Pointing at him
ᏎᎼᏂ	Other	ᏎᎼᏂ:Salmon
ᏎᏅᏏ	Other	ᏎᏅᏏ:Cent (English Borrowing)
ᏎᏍᏗ	Deverbal	ᎠᏎᎯᎭ:Pointing at him
ᏎᏗ	Other	ᏎᏗ:Walnut
ᏎᏗᏳᏍᏗ	Other	ᏎᏗᏳᏍᏗ:Pear
ᏎᏩᏓ	Other	ᏎᏩᏓ:Hornet
Ꮟ	Other	Ꮟ:Wait
ᏏᎦᏓᏍᎩ	Other	ᏏᎦᏓᏍᎩ:Genus: Smilas Herbacea
ᏏᎭ	PresentContinous	ᎠᏏᎭ:Removing from a shelf
ᏏᎳᏉ	Other	ᏏᎳᏉ:Sylva, NC
ᏏᎳᏛᎥᎦ	Immediate	ᎠᏏᎳᏛᎥᏍᎦ:Wiring
ᏏᎳᏛᎥᏍᎦ	PresentContinous	ᎠᏏᎳᏛᎥᏍᎦ:Wiring
ᏏᎳᏛᎥᏍᎪᎢ	Habitual	ᎠᏏᎳᏛᎥᏍᎦ:Wiring
ᏏᎳᏛᏅᎢ	RemotePast	ᎠᏏᎳᏛᎥᏍᎦ:Wiring
ᏏᎳᏛᏗ	Deverbal	ᎠᏏᎳᏛᎥᏍᎦ:Wiring
ᏏᎸᎢ	Other	ᏏᎸᎢ:Wait a minute
ᏏᎾᎭ	PresentContinous	ᎠᏏᎾᎭ:Skilled
ᏏᎾᎲᎭ	Immediate	ᎠᏏᎾᎭ:Skilled
ᏏᎾᎲᏒᎢ	RemotePast	ᎠᏏᎾᎭ:Skilled
ᏏᎾᏌᏅᎦ	PresentContinous	ᎠᏏᎾᏌᏅᎦ:Skilled (becoming)
ᏏᎾᏌᏅᎪᎢ	Habitual	ᎠᏏᎾᏌᏅᎦ:Skilled (becoming)
ᏏᎾᏌᏅᎭ	Immediate	ᎠᏏᎾᏌᏅᎦ:Skilled (becoming)
ᏏᎾᏌᏅᏗ	Deverbal	ᎠᏏᎾᏌᏅᎦ:Skilled (becoming)
ᏏᎾᏌᏅᏨᎢ	RemotePast	ᎠᏏᎾᏌᏅᎦ:Skilled (becoming)
ᏏᎾᏍᎪᎢ	Habitual	ᎠᏏᎾᎭ:Skilled
ᏏᎾᏒᏍᏗ	Deverbal	ᎠᏏᎾᎭ:Skilled
ᏏᏅᏍᏓ	Immediate	ᎠᏏᏅᏍᏗᎭ:Coaching
ᏏᏅᏍᏓᏅᎢ	RemotePast	ᎠᏏᏅᏍᏗᎭ:Coaching
ᏏᏅᏍᏗᎭ	PresentContinous	ᎠᏏᏅᏍᏗᎭ:Coaching
ᏏᏅᏍᏗᏍᎪᎢ	Habitual	ᎠᏏᏅᏍᏗᎭ:Coaching
ᏏᏅᏍᏙᏗ	Deverbal	ᎠᏏᏅᏍᏗᎭ:Coaching
ᏏᏅᏓ	Other	ᏏᏅᏓ:Month
ᏏᏆ	Other	ᏏᏆ:Pig
ᏏᏈᏲ	Other	ᏏᏈᏲ:Sevierville, TN
ᏏᏉ	Other	ᏏᏉ:More
ᏏᏍᎪᎢ	Habitual	ᎠᏏᎭ:Removing from a shelf
ᏏᏎᎦ	Other	ᏏᏎᎦ:Wait a while
ᏏᏩᎭ	Immediate	ᎤᏏᏩᏍᎦ:Coughing
ᏏᏩᎲᎢ	RemotePast	ᎤᏏᏩᏍᎦ:Coughing
ᏏᏩᏍᎦ	PresentContinous	ᎤᏏᏩᏍᎦ:Coughing
ᏏᏩᏍᎪᎢ	Habitual	ᎤᏏᏩᏍᎦ:Coughing
ᏏᏩᏍᏗ	Deverbal	ᎤᏏᏩᏍᎦ:Coughing
ᏏᏴᎠ	PresentContinous	ᎠᏏᏴᎠ:Pushing something long aside
ᏏᏴᎥᎢ	RemotePast	ᎠᏏᏴᎠ:Pushing something long aside
ᏏᏴᎾ	Immediate	ᎠᏏᏴᎠ:Pushing something long aside
ᏏᏴᏍᎪᎢ	Habitual	ᎠᏏᏴᎠ:Pushing something long aside
ᏏᏴᏍᏗ	Deverbal	ᎠᏏᏴᎠ:Pushing something long aside
ᏐᎣᏁᎳ	Other	ᏐᎣᏁᎳ:Nine
ᏐᎣᏁᎳᏍᎪᎯ	Other	ᏐᎣᏁᎳᏍᎪᎯ:Ninety
ᏐᎣᏁᎳᏚᎯ	Other	ᏐᎣᏁᎳᏚᎯ:Nineteen
ᏐᎣᏅᏓ	Immediate	ᎠᏐᎣᏅᏗᎭ:Dropping something long
ᏐᎣᏅᏔᏅᎢ	RemotePast	ᎠᏐᎣᏅᏗᎭ:Dropping something long
ᏐᎣᏅᏗᎭ	PresentContinous	ᎠᏐᎣᏅᏗᎭ:Dropping something long
ᏐᎣᏅᏗᏍᎪᎢ	Habitual	ᎠᏐᎣᏅᏗᎭ:Dropping something long
ᏐᎣᏅᏙᏗ	Deverbal	ᎠᏐᎣᏅᏗᎭ:Dropping something long
ᏐᎦ	Immediate	ᏓᏐᎧ:Crossing
ᏐᎧ	PresentContinous	ᏓᏐᎧ:Crossing
ᏐᎩ	Other	ᏐᎩ:Waynesville, NC
ᏐᎪᎢ	Habitual	ᏓᏐᎧ:Crossing
ᏐᎯ	Other	ᏐᎯ:Hickory nut
ᏐᎯᏍᏗ	Deverbal	ᏓᏐᎧ:Crossing
ᏐᏈᎵ	Other	ᏐᏈᎵ:Horse
ᏐᏊ	Other	ᏐᏊ:One
ᏐᏚᎯ	Other	ᏐᏚᎯ:Eleven
ᏐᏤᎾ	Other	ᏐᏤᎾ:Sochana
ᏐᏨᎢ	RemotePast	ᏓᏐᎧ:Crossing
ᏑᎳ	Immediate	ᎤᏑᎵᎭ:Full
ᏑᎳᎪᎢᏍᏗ	Deverbal	ᎤᏑᎳᎪᎦ:Lonesome
ᏑᎳᎪᎦ	PresentContinous	ᎤᏑᎳᎪᎦ:Lonesome
ᏑᎳᎪᎪᎢ	Habitual	ᎤᏑᎳᎪᎦ:Lonesome
ᏑᎳᎪᏣᎥᎢ	RemotePast	ᎤᏑᎳᎪᎦ:Lonesome
ᏑᎵ	Other	ᏑᎵ:Turkey vulture
ᏑᎵᎭ	PresentContinous	ᎤᏑᎵᎭ:Full
ᏑᎵᏍᎪᎢ	Habitual	ᎤᏑᎵᎭ:Full
ᏑᎵᏗ	Deverbal	ᎤᏑᎵᎭ:Full
ᏑᎸᎲᎢ	RemotePast	ᎤᏑᎵᎭ:Full
ᏑᎾᎴᎢ	Other	ᏑᎾᎴᎢ:Tomorrow
ᏑᎾᎴᎢᏣ	Other	ᏑᎾᎴᎢᏣ:Dawn
ᏑᎾᏙᏓᏆᏍᏗ	Other	ᏑᎾᏙᏓᏆᏍᏗ:Week
ᏑᏒᎯᏓ	Other	ᏑᏒᎯᏓ:Overnight
ᏑᏓᎴᎦ	Other	ᏑᏓᎴᎦ:One thing
ᏑᏓᎵ	Other	ᏑᏓᎵ:Six
ᏑᏓᎵᏍᎪᎯ	Other	ᏑᏓᎵᏍᎪᎯ:Sixty
ᏑᏕᏘᏴᏓ	Other	ᏑᏕᏘᏴᏓ:Year
ᏑᏥᎶᏓ	Other	ᏑᏥᎶᏓ:Yard (measurement)
ᏑᏩ	Immediate	ᏓᏑᏫᏍᎦ:Barking
ᏑᏫᏍᎦ	PresentContinous	ᏓᏑᏫᏍᎦ:Barking
ᏑᏫᏍᎪᎢ	Habitual	ᏓᏑᏫᏍᎦ:Painting
ᏑᏫᏍᏗ	Deverbal	ᏓᏑᏫᏍᎦ:Painting
ᏑᏫᏒᎢ	RemotePast	ᏓᏑᏫᏍᎦ:Barking
ᏑᏲᎰᏅᏓ	Immediate	ᏕᎦᏑᏲᎰᏅᏗᎭ:Sliding it
ᏑᏲᎰᏅᏔᏅᎢ	RemotePast	ᏕᎦᏑᏲᎰᏅᏗᎭ:Sliding it
ᏑᏲᎰᏅᏗᎭ	PresentContinous	ᏕᎦᏑᏲᎰᏅᏗᎭ:Sliding it
ᏑᏲᎰᏅᏗᏍᎪᎢ	Habitual	ᏕᎦᏑᏲᎰᏅᏗᎭ:Sliding it
ᏑᏲᎰᏅᏙᏗ	Deverbal	ᏕᎦᏑᏲᎰᏅᏗᎭ:Sliding it
ᏒᎥᎦ	Immediate	ᎠᏒᎥᏍᎦ:Putting something flexible up
ᏒᎥᏍᎦ	PresentContinous	ᎠᏒᎥᏍᎦ:Putting something flexible up
ᏒᎥᏍᎪᎢ	Habitual	ᎠᏒᎥᏍᎦ:Putting something flexible up
ᏒᎦᏔ	Other	ᏒᎦᏔ:Apple (all varieties)
ᏒᎩ	Other	ᏒᎩ:Mink
ᏒᎯᏰᏱᏗᏣ	Other	ᏒᎯᏰᏱᏗᏣ:Afternoon
ᏒᎲᎢ	RemotePast	ᎠᏏᎭ:Removing from a shelf
ᏒᎾᏔᎦ	Immediate	ᎠᏒᎾᏔᏍᎦ:Roasting it
ᏒᎾᏔᏅᎢ	RemotePast	ᎠᏒᎾᏔᏍᎦ:Roasting it
ᏒᎾᏔᏍᎦ	PresentContinous	ᎠᏒᎾᏔᏍᎦ:Roasting it
ᏒᎾᏔᏍᎪᎢ	Habitual	ᎠᏒᎾᏔᏍᎦ:Roasting it
ᏒᎾᏘ	Deverbal	ᎠᏒᎾᏔᏍᎦ:Roasting it
ᏒᏅᎢ	RemotePast	ᎠᏒᎥᏍᎦ:Putting something flexible up
ᏒᏓᎷᎩ	Other	ᏒᏓᎷᎩ:Shingle
ᏒᏔᎦ	Immediate	ᎦᏒᏔᏍᎦ:Stacking it
ᏒᏔᏅᎢ	RemotePast	ᎦᏒᏔᏍᎦ:Stacking it
ᏒᏔᏍᎦ	PresentContinous	ᎦᏒᏔᏍᎦ:Stacking it
ᏒᏔᏍᎪᎢ	Habitual	ᎦᏒᏔᏍᎦ:Stacking it
ᏒᏗ	Deverbal	ᎠᏏᎭ:Removing from a shelf	ᎠᏒᎥᏍᎦ:Putting something flexible up
ᏒᏗᏩᎵ	Other	ᏒᏗᏩᎵ:Raspberries
ᏒᏘᏗ	Deverbal	ᎦᏒᏔᏍᎦ:Stacking it
ᏒᏙᏂ	Other	ᏒᏙᏂ:Barrel
ᏒᏣᏓ	Immediate	ᎠᏒᏣᏗᎠ:Bridging it
ᏒᏣᏗᎠ	PresentContinous	ᎠᏒᏣᏗᎠ:Bridging it
ᏒᏣᏗᏍᎪᎢ	Habitual	ᎠᏒᏣᏗᎠ:Bridging it
ᏒᏣᏗᏍᏗ	Deverbal	ᎠᏒᏣᏗᎠ:Bridging it
ᏒᏣᏛᎢ	RemotePast	ᎠᏒᏣᏗᎠ:Bridging it
Ꮣ	Immediate	ᎠᏗᎠ:Placing something long on the ground
ᏓᎦᎩ	Other	ᏓᎦᎩ:Genus: Rumex Cripis
ᏓᎦᏏ	Other	ᏓᎦᏏ:Terrapin
ᏓᎧᏅᎢ	Other	ᎠᎧᏅᎢ:Eye
ᏓᎩᎵᏍᏆᏗᏍᎬᎢ	Other	ᎤᎵᏍᏆᏗᏍᎬᎢ:Earache
ᏓᎩᏰᏑᎧᎸᎢ	Other	ᎤᏰᏑᎧᎸᎢ:Fingernail
ᏓᎩᏰᏑᏨᏂ	Other	ᎤᏰᏑᏨᏂ:Wrist
ᏓᎳᎳ	Other	ᏓᎳᎳ:Red-headed woodpecker
ᏓᎳᏍᎨᏫ	Other	ᏓᎳᏍᎨᏫ:Shrew
ᏓᎳᏍᏙᎬ	Other	ᏓᎳᏍᏙᎬ:Night hawk
ᏓᎳᏚᎯ	Other	ᏓᎳᏚᎯ:Sixteen
ᏓᎴᏍᎩᏍᎩ	Other	ᏓᎴᏍᎩᏍᎩ:Monkey
ᏓᎴᏴᏍᎩ	Other	ᏓᎴᏴᏍᎩ:Salamander
ᏓᎶᎨ	Other	ᏓᎶᎨ:Hog sucker (plant)
ᏓᎶᎬ	Other	ᏓᎶᎬ:Rain raven (plant)
ᏓᎶᏂ	Other	ᏓᎶᏂ:Gall bladder
ᏓᎷᎦᎦ	Immediate	ᎦᏓᎷᎩᎠ:Plowing
ᏓᎷᎦᏅᎢ	RemotePast	ᎦᏓᎷᎩᎠ:Plowing
ᏓᎷᎩᎠ	PresentContinous	ᎦᏓᎷᎩᎠ:Plowing
ᏓᎷᎩᏍᎪᎢ	Habitual	ᎦᏓᎷᎩᎠ:Plowing
ᏓᎷᎪᏗ	Deverbal	ᎦᏓᎷᎩᎠ:Plowing
ᏓᏂᎳᏍᏓᏛᎢ	Other	ᏓᏂᎳᏍᏓᏛᎢ:Clan members
ᏓᏃᎳᎦ	Immediate	ᏕᎦᏓᏃᎳᎩᎠ:Stringing beans
ᏓᏃᎳᎩᎠ	PresentContinous	ᏕᎦᏓᏃᎳᎩᎠ:Stringing beans
ᏓᏃᎳᎩᏍᎪᎢ	Habitual	ᏕᎦᏓᏃᎳᎩᎠ:Stringing beans
ᏓᏃᎳᎩᏍᏗ	Deverbal	ᏕᎦᏓᏃᎳᎩᎠ:Stringing beans
ᏓᏃᎳᎩᏒᎢ	RemotePast	ᏕᎦᏓᏃᎳᎩᎠ:Stringing beans
ᏓᏄᎳᏥᏴᎢ	Other	ᎠᏄᎳᏥᏴᎢ:Ribs
ᏓᏆᎴᎷ	Other	ᏓᏆᎴᎷ:Car
ᏓᏆᎵᏗᎾᎥᎢ	Other	ᏚᎵᏗᎾᎥᎢ:Family
ᏓᏆᏚᏂ	Other	ᏧᏩᏚᏂ:Veins
ᏓᏑᏓᏆᎴᏆ	Other	ᏓᏑᏓᏆᎴᏆ:Mountain oak
ᏓᏰᏌᏛᎢ	Other	ᎠᏰᏌᏛᎢ:Finger
ᏓᏲᎭ	Immediate	ᎠᏓᏲᏍᎦ:Surrendering
ᏓᏲᎭᎦ	Immediate	ᎦᏓᏲᎯᎭ:Playing marbles
ᏓᏲᎯᎭ	PresentContinous	ᎦᏓᏲᎯᎭ:Playing marbles
ᏓᏲᎯᎰᎢ	Habitual	ᎦᏓᏲᎯᎭ:Playing marbles
ᏓᏲᎯᏍᏗ	Deverbal	ᎠᏓᏲᏍᎦ:Surrendering
ᏓᏲᎸᎢ	RemotePast	ᎦᏓᏲᎯᎭ:Playing marbles
ᏓᏲᏍᎦ	PresentContinous	ᎠᏓᏲᏍᎦ:Surrendering
ᏓᏲᏍᎪᎢ	Habitual	ᎠᏓᏲᏍᎦ:Surrendering
ᏓᏲᏍᏗ	Deverbal	ᎦᏓᏲᎯᎭ:Playing marbles
ᏓᏲᏒᎢ	RemotePast	ᎠᏓᏲᏍᎦ:Surrendering
ᏔᎳ	Other	ᏔᎳ:Oak
ᏔᎳᎦ	Immediate	ᎠᏔᎳᎦᏍᎦ:Penetrating
ᏔᎳᎦᏍᎦ	PresentContinous	ᎠᏔᎳᎦᏍᎦ:Penetrating
ᏔᎳᎦᏍᎪᎢ	Habitual	ᎠᏔᎳᎦᏍᎦ:Penetrating
ᏔᎳᎦᏍᏗ	Deverbal	ᎠᏔᎳᎦᏍᎦ:Penetrating
ᏔᎳᎦᏒᎢ	RemotePast	ᎠᏔᎳᎦᏍᎦ:Penetrating
ᏔᎳᏚ	Other	ᏔᎳᏚ:Genus: Achata Assimilis
ᏔᎳᏚᎯ	Other	ᏔᎳᏚᎯ:Twelve
ᏔᎵ	Other	ᏔᎵ:Two
ᏔᎵᏁ	Other	ᏔᎵᏁ:Tuesday
ᏔᎵᏍᎪᎯ	Other	ᏔᎵᏍᎪᎯ:Twenty
ᏔᎵᏥᏆ	Other	ᏔᎵᏥᏆ:Two hundred
ᏔᎷᎦᎥᎢ	RemotePast	ᎤᏔᎷᎩᎠ:Shining
ᏔᎷᎦᎦ	Immediate	ᎤᏔᎷᎩᎠ:Shining
ᏔᎷᎩᎠ	PresentContinous	ᎤᏔᎷᎩᎠ:Shining
ᏔᎷᎩᏍᎩ	Other	ᏔᎷᎩᏍᎩ:Tin can
ᏔᎷᎩᏍᎪᎢ	Habitual	ᎤᏔᎷᎩᎠ:Shining
ᏔᎷᎪᏗ	Deverbal	ᎤᏔᎷᎩᎠ:Shining
ᏔᎷᏣ	Other	ᏔᎷᏣ:Basket
ᏔᎾᏏ	Other	ᏔᎾᏏ:Tennessee
ᏔᏁᏆ	Other	ᏔᏁᏆ:Mule (animal)
ᏔᏆᎴᎦ	Immediate	ᏕᎦᏔᏆᎴᏍᎦ:Making pottery
ᏔᏆᎴᎸᎢ	RemotePast	ᏕᎦᏔᏆᎴᏍᎦ:Making pottery
ᏔᏆᎴᏍᎦ	PresentContinous	ᏕᎦᏔᏆᎴᏍᎦ:Making pottery
ᏔᏆᎴᏍᎪᎢ	Habitual	ᏕᎦᏔᏆᎴᏍᎦ:Making pottery
ᏔᏆᎴᏍᏗ	Deverbal	ᏕᎦᏔᏆᎴᏍᎦ:Making pottery
ᏔᏆᎵ	Other	ᏔᏆᎵ:Genus: Tadescantia Sp
ᏔᏕᎦ	Immediate	ᎤᏔᏕᎩᎠ:Thirsty
ᏔᏕᎩᎠ	PresentContinous	ᎤᏔᏕᎩᎠ:Thirsty
ᏔᏕᎩᏍᎪᎢ	Habitual	ᎤᏔᏕᎩᎠ:Thirsty
ᏔᏕᎩᏍᏗ	Deverbal	ᎤᏔᏕᎩᎠ:Thirsty
ᏔᏕᎩᏒᎢ	RemotePast	ᎤᏔᏕᎩᎠ:Thirsty
ᏔᏪᏙᏅᎢ	RemotePast	ᎠᏔᏪᏙᏍᎦ:Kissing
ᏔᏪᏙᏍᎦ	PresentContinous	ᎠᏔᏪᏙᏍᎦ:Kissing
ᏔᏪᏙᏍᎪᎢ	Habitual	ᎠᏔᏪᏙᏍᎦ:Kissing
ᏔᏪᏙᏍᏗ	Deverbal	ᎠᏔᏪᏙᏍᎦ:Kissing
ᏔᏬᎠ	PresentContinous	ᎠᏔᏬᎠ:Combing
ᏔᏬᎥᎢ	RemotePast	ᎠᏔᏬᎠ:Combing
ᏔᏬᏍᎪᎢ	Habitual	ᎠᏔᏬᎠ:Combing
ᏔᏬᏍᏗ	Deverbal	ᎠᏔᏬᎠ:Combing
ᏔᏬᏗ	Other	ᏔᏬᏗ:Hawk
ᏔᏬᏣ	Immediate	ᎠᏔᏬᎠ:Combing
ᏔᏯ	Other	ᏔᏯ:Genus: Prunus Sp
ᏔᏲᎭᎦ	Immediate	ᎠᏔᏲᎯᎭ:Requesting
ᏔᏲᎯᎭ	PresentContinous	ᎠᏔᏲᎯᎭ:Requesting
ᏔᏲᎯᎰᎢ	Habitual	ᎠᏔᏲᎯᎭ:Requesting
ᏔᏲᎸᎢ	RemotePast	ᎠᏔᏲᎯᎭ:Requesting
ᏔᏲᏍᏗ	Deverbal	ᎠᏔᏲᎯᎭ:Requesting
ᏔᏲᏎᎭ	PresentContinous	ᎠᏔᏲᏎᎭ:Asking him for it
ᏔᏲᏎᎰᎢ	Habitual	ᎠᏔᏲᏎᎭ:Asking him for it
ᏔᏲᏎᎸᎢ	RemotePast	ᎠᏔᏲᏎᎭ:Asking him for it
ᏔᏲᏎᏌ	Immediate	ᎠᏔᏲᏎᎭ:Asking him for it
ᏔᏲᏎᏗ	Deverbal	ᎠᏔᏲᏎᎭ:Asking him for it
ᏔᏳᎭᎵ	Other	ᏔᏳᎭᎵ:Genus: Sceloporus Undulatus
ᏕᎥᏍᏗ	Deverbal	ᏓᏕᎦ:Placing long things into a row
ᏕᎦ	PresentContinous	ᏓᏕᎦ:Placing long things into a row
ᏕᎦᎵᏗ	Other	ᏕᎦᎵᏗ:Cloth sack
ᏕᎦᎾᏌᏛᎢ	Other	ᎦᎾᏌᏛᎢ:Toe
ᏕᎦᏅᏙᎧ	Other	ᎦᏅᏙᎧ:Tooth
ᏕᎦᏗᎨᏂ	Other	ᎦᏗᎨᏂ:Heel (of foot)
ᏕᎧ	Other	ᏕᎧ:Frog
ᏕᎪᎢ	Habitual	ᏓᏕᎦ:Placing long things into a row
ᏕᎭ	PresentContinous	ᎠᏕᎭ:Giving something long to him
ᏕᎯ	Deverbal	ᎠᏕᎭ:Giving something long to him
ᏕᎰᎢ	Habitual	ᎠᏕᎭ:Giving something long to him
ᏕᎷᎨ	Other	ᏕᎷᎨ:Purple
ᏕᎷᏱ	Other	ᏕᎷᏱ:June
ᏕᎸᎢ	RemotePast	ᎠᏕᎭ:Giving something long to him
ᏕᏒᎢ	RemotePast	ᏓᏕᎦ:Placing long things into a row
ᏕᏣᎵᏗᎾᎢ	Other	ᏕᏣᎵᏗᎾᎢ:Your family
ᏕᏥᎧᏅᎢ	Other	ᎠᎧᏅᎢ:Eye
ᏕᏥᎾᏌᏛᎢ	Other	ᎦᎾᏌᏛᎢ:Toe
ᏕᏥᏄᎳᏥᏴᎢ	Other	ᎠᏄᎳᏥᏴᎢ:Ribs
ᏕᏥᏅᏙᎧ	Other	ᎦᏅᏙᎧ:Tooth
ᏕᏥᏗᎨᏂ	Other	ᎦᏗᎨᏂ:Heel (of foot)
ᏕᏥᏰᏌᏛᎢ	Other	ᎠᏰᏌᏛᎢ:Finger
ᏕᏩ	Other	ᏕᏩ:Genus: Glaucomys Vulans
ᏖᎳᏕᎣᏗ	Deverbal	ᎠᏖᎳᏕᎭ:Joining
ᏖᎳᏕᎭ	PresentContinous	ᎠᏖᎳᏕᎭ:Joining
ᏖᎳᏕᎭᏅᎢ	RemotePast	ᎠᏖᎳᏕᎭ:Joining
ᏖᎳᏕᎰᎢ	Habitual	ᎠᏖᎳᏕᎭ:Joining
ᏖᎸᎲᎦ	Immediate	ᎠᏖᎸᎲᏍᎦ:Shaking it
ᏖᎸᎲᏍᎦ	PresentContinous	ᎠᏖᎸᎲᏍᎦ:Shaking it
ᏖᎸᎲᏍᎪᎢ	Habitual	ᎠᏖᎸᎲᏍᎦ:Shaking it
ᏖᎸᎳᏗ	Other	ᏖᎸᎳᏗ:Wild fox grapes
ᏖᎸᏅᎢ	RemotePast	ᎠᏖᎸᎲᏍᎦ:Shaking it
ᏖᎸᏗ	Deverbal	ᎠᏖᎸᎲᏍᎦ:Shaking it
ᏖᏍᏓ	Immediate	ᏓᏖᏍᏗᎭ:Ironing clothes
ᏖᏍᏓᏅᎢ	RemotePast	ᏓᏖᏍᏗᎭ:Ironing clothes
ᏖᏍᏔᏅᎢ	RemotePast	ᎠᏖᏍᏗᎭ:Startling him
ᏖᏍᏗᎭ	PresentContinous	ᎠᏖᏍᏗᎭ:Startling him	ᏓᏖᏍᏗᎭ:Ironing clothes
ᏖᏍᏗᏍᎪᎢ	Habitual	ᎠᏖᏍᏗᎭ:Startling him	ᏓᏖᏍᏗᎭ:Ironing clothes
ᏖᏍᏙᏗ	Deverbal	ᎠᏖᏍᏗᎭ:Startling him
ᏖᏍᏙᏘ	Deverbal	ᏓᏖᏍᏗᎭ:Ironing clothes
Ꮧ	Deverbal	ᎠᎲᏍᎦ:Laying down something solid
ᏗᎠ	PresentContinous	ᎠᏗᎠ:Placing something long on the ground
ᏗᎤᏓᏍᎦ	Other	ᏗᎤᏓᏍᎦ:Bush
ᏗᎦᎦᎸᏅᎯᏓ	Other	ᏗᎦᎦᎸᏅᎯᏓ:Weeping willow
ᏗᎦᎦᏆᎴᏂ	Other	ᎦᎦᏆᎴᏂ:Cheek
ᏗᎦᎦᏛᎾᎯᏛ	Other	ᏗᎦᎦᏛᎾᎯᏛ:Long tailed sharp-shinned hawk
ᏗᎦᎳᏫ'ᎢᏍᏗ	Other	ᏗᎦᎳᏫ'ᎢᏍᏗ:Meeting
ᏗᎦᎳᏫᎢᏍᏗ	Other	ᏗᎦᎳᏫᎢᏍᏗ:Council house
ᏗᎦᎴᏂ	Other	ᎦᎴᏂ:Ear
ᏗᎦᎸᏌᏓᏗᏍᏗᎯᏍᎩ	Other	ᏗᎦᎸᏌᏓᏗᏍᏗᎯᏍᎩ:Movie projector
ᏗᎦᎸᏫᏍᏓᏁᏗ	Other	ᏗᎦᎸᏫᏍᏓᏁᏗ:Place of work
ᏗᎦᏅᏐᏍᏙᏗ	Other	ᏗᎦᏅᏐᏍᏙᏗ:Brake (on a vehicle)
ᏗᎦᏍᏓᎨᏂ	Other	ᎦᏍᏓᎨᏂ:Calf of the leg
ᏗᎦᏘ	Other	ᏗᎦᏘ:Shepherd
ᏗᎦᏙᎵ	Other	ᎠᎦᏙᎵ:Eye
ᏗᎦᏚᎲᏱ	Other	ᏗᎦᏚᎲᏱ:Town at a distance
ᏗᎧᏃᎩᏍᏙᏗ	Other	ᏗᎧᏃᎩᏍᏙᏗ:Hymn book
ᏗᎧᏍᎨᏂ	Other	ᎠᎧᏍᎨᏂ:Hip
ᏗᎨᏛᏍᏗ	Other	ᏗᎨᏛᏍᏗ:Post
ᏗᎩᏥ	Other	ᏗᎩᏥ:Tadpole
ᏗᎪᏓᎳᏗ	Other	ᏗᎪᏓᎳᏗ:Pepper (black)
ᏗᎪᏪᎵᏍᎩ	Other	ᏗᎪᏪᎵᏍᎩ:Writer
ᏗᎪᏪᎶᏗ	Other	ᏗᎪᏪᎶᏗ:Pencil
ᏗᎫᏍᎨᏂ	Other	ᎠᎫᏍᎨᏂ:Elbow
ᏗᎫᏣᎾᎩᏍᏗ	Other	ᏗᎫᏣᎾᎩᏍᏗ:Accordian
ᏗᎬᎩᎣᏍᎩ	Other	ᏗᎬᎩᎣᏍᎩ:Washing machine
ᏗᎬᎴᏲᏍᏗ	Other	ᏗᎬᎴᏲᏍᏗ:Patchwork (for quilt)
ᏗᎬᏂᎨᎢ	Other	ᏗᎬᏂᎨᎢ:Genus: Quercus L
ᏗᎬᏃᎨᏂ	Other	ᎠᎬᏃᎨᏂ:Wing
ᏗᎳᏍᎦᎵᏗ	Other	ᏗᎳᏍᎦᎵᏗ:Ball sticks
ᏗᎴᎯ	Deverbal	ᎤᏗᎴᎲᏍᎦ:Fever, to have a
ᏗᎴᎲᎦ	Immediate	ᎤᏗᎴᎲᏍᎦ:Fever, to have a
ᏗᎴᎲᏍᎦ	PresentContinous	ᎤᏗᎴᎲᏍᎦ:Fever, to have a
ᏗᎴᎲᏍᎪᎢ	Habitual	ᎤᏗᎴᎲᏍᎦ:Fever, to have a
ᏗᎴᏅᎢ	RemotePast	ᎤᏗᎴᎲᏍᎦ:Fever, to have a
ᏗᎴᏆ	Other	ᏗᎴᏆ:Kingbird
ᏗᎴᏰᏑᎶ	Other	ᏗᎴᏰᏑᎶ:Gloves
ᏗᎵ	Other	ᏗᎵ:Skunk
ᏗᎵᎦᎵᏍᎩ	Other	ᏗᎵᎦᎵᏍᎩ:Pussywillow
ᏗᎵᏃᎮᏗ	Other	ᏗᎵᏃᎮᏗ:Telephone
ᏗᎵᏍᏙᏗ	Other	ᏗᎵᏍᏙᏗ:Scissors
ᏗᎵᏔᏬᏍᏙᏗ	Other	ᏗᎵᏔᏬᏍᏙᏗ:Comb
ᏗᎾᎵᏅᏥ	Other	ᏗᎾᎵᏅᏥ:Brothers
ᏗᎾᏓᏍᏓᏍᎩ	Other	ᏗᎾᏓᏍᏓᏍᎩ:Genus: Viola Spp
ᏗᎾᏛᏁᎵᏍᎬᎢ	Other	ᏗᎾᏛᏁᎵᏍᎬᎢ:Show
ᏗᏂᎶᏫ	Other	ᏗᏂᎶᏫ:Twins
ᏗᏅᏬᏍᏙᏗ	Other	ᏗᏅᏬᏍᏙᏗ:Bed clothes
ᏗᏆᎪᏅ	Other	ᎤᎪᏅ:Testicle
ᏗᏆᎸᏕᏓ	Immediate	ᎦᏗᏆᎸᏕᏗᎭ:Twirl it
ᏗᏆᎸᏕᏔᏅᎢ	RemotePast	ᎦᏗᏆᎸᏕᏗᎭ:Twirl it
ᏗᏆᎸᏕᏗᎭ	PresentContinous	ᎦᏗᏆᎸᏕᏗᎭ:Twirl it
ᏗᏆᎸᏕᏗᏍᎪᎢ	Habitual	ᎦᏗᏆᎸᏕᏗᎭ:Twirl it
ᏗᏆᎸᏕᏙᏗ	Deverbal	ᎦᏗᏆᎸᏕᏗᎭ:Twirl it
ᏗᏆᏅᏌᏗ	Other	ᎤᏅᏌᏗ:Rattle wrapped around the leg
ᏗᏇᏅᏒᎢ	Other	ᎤᏪᏅᏒᎢ:Home
ᏗᏇᏥ	Other	ᎤᏪᏥ:Offspring
ᏗᏌ	Immediate	ᎠᏕᎭ:Giving something long to him
ᏗᏍᎪᎢ	Habitual	ᎠᏗᎠ:Placing something long on the ground
ᏗᏍᏗ	Deverbal	ᎠᏗᎠ:Placing something long on the ground
ᏗᏎᏍᏗ	Other	ᏗᏎᏍᏗ:Numbers
ᏗᏏᏯ	PresentContinous	ᎠᏗᏏᏯ:Leaving something long
ᏗᏏᏱᏍᎪᎢ	Habitual	ᎠᏗᏏᏯ:Leaving something long
ᏗᏏᏱᏗ	Deverbal	ᎠᏗᏏᏯ:Leaving something long
ᏗᏓᎾᏏᏁᎩ	Other	ᏗᏓᎾᏏᏁᎩ:Sled
ᏗᏓᎾᏫᏓ	Other	ᏗᏓᎾᏫᏓ:Cross
ᏗᏓᏂᏐᏗᏳ	Other	ᏗᏓᏂᏐᏗᏳ:Cemetary
ᏗᏓᏂᏥᏍᎩ	Other	ᏗᏓᏂᏥᏍᎩ:Policeman
ᏗᏓᏅᎢ	Other	ᏗᏓᏅᎢ:Store at a distance
ᏗᏓᏅᏬᏙᏗ	Other	ᏗᏓᏅᏬᏙᏗ:Treatment (medical)
ᏗᏓᏍᏙᏰᏍᎩ	Other	ᏗᏓᏍᏙᏰᏍᎩ:Barber
ᏗᏓᏍᏚᏗᏳ	Other	ᏗᏓᏍᏚᏗᏳ:Jail
ᏗᏓᏥᎶᏍᏗᏍᎩ	Other	ᏗᏓᏥᎶᏍᏗᏍᎩ:Photographer
ᏗᏓᏬᏍᎩ	Other	ᏗᏓᏬᏍᎩ:Baptist
ᏗᏕᎶᏆᏍᎩ	Other	ᏗᏕᎶᏆᏍᎩ:Student
ᏗᏕᎶᏆᏍᏗ	Other	ᏗᏕᎶᏆᏍᏗ:School
ᏗᏕᏍᏗᏓᏁᏆ	Other	ᏗᏕᏍᏗᏓᏁᏆ:Castor oil beans
ᏗᏕᏲᎲᏍᎩ	Other	ᏗᏕᏲᎲᏍᎩ:Teacher
ᏗᏖᏍᏗ	Other	ᏗᏖᏍᏗ:Iron (to iron clothes with)
ᏗᏘᏲᎯᎯ	Other	ᏗᏘᏲᎯᎯ:Lawyer
ᏗᏙᎴᏍᎩ	Other	ᏗᏙᎴᏍᎩ:Rheumatism
ᏗᏥᎦᏆᎴᏂ	Other	ᎦᎦᏆᎴᏂ:Cheek
ᏗᏥᎦᏙᎵ	Other	ᎠᎦᏙᎵ:Eye
ᏗᏥᎧᏍᎨᏂ	Other	ᎠᎧᏍᎨᏂ:Hip
ᏗᏥᎫᏍᎨᏂ	Other	ᎠᎫᏍᎨᏂ:Elbow
ᏗᏥᎴᏂ	Other	ᎦᎴᏂ:Ear
ᏗᏥᎶᏍᏓᏅᎯ	Other	ᏗᏥᎶᏍᏓᏅᎯ:Picture
ᏗᏥᏍᏓᎨᏂ	Other	ᎦᏍᏓᎨᏂ:Calf of the leg
ᏗᏥᏳᎪᎢ	Other	ᎠᏳᎪᎢ:Jaw
ᏗᏪᏓᎶᎯ	Other	ᏗᏪᏓᎶᎯ:White breasted nuthatch
ᏗᏳᎪᎢ	Other	ᎠᏳᎪᎢ:Jaw
ᏗᏴᎢ	RemotePast	ᎠᏗᏏᏯ:Leaving something long
ᏗᏴᎩᏍᏗ	Other	ᏗᏴᎩᏍᏗ:Banjo
ᏘᎵ	Other	ᏘᎵ:Genus: Castanea Dentata
ᏘᎾ	Other	ᏘᎾ:Lice
ᏘᏁᏒᎢ	RemotePast	ᎠᏘᏂ:Taking someone along
ᏘᏂ	PresentContinous	ᎠᏘᏂ:Taking someone along
ᏘᏂᏐᎢ	Habitual	ᎠᏘᏂ:Taking someone along
ᏘᏄᎦ	Immediate	ᎠᏘᏂ:Taking someone along
ᏘᏅᏍᏗ	Deverbal	ᎠᏘᏂ:Taking someone along
ᏙᎢᏳᏍᏗ	Other	ᏙᎢᏳᏍᏗ:What
ᏙᎣᎭ	Immediate	ᎦᏙᎣᏍᎦ:Falling (something flexible or something liquid)
ᏙᎣᎯᏍᏗ	Deverbal	ᎦᏙᎣᏍᎦ:Falling (something flexible or something liquid)
ᏙᎣᏍᎦ	PresentContinous	ᎦᏙᎣᏍᎦ:Falling (something flexible or something liquid)
ᏙᎣᏍᎪᎢ	Habitual	ᎦᏙᎣᏍᎦ:Falling (something flexible or something liquid)
ᏙᎣᏒᎢ	RemotePast	ᎦᏙᎣᏍᎦ:Falling (something flexible or something liquid)
ᏙᎦ	PresentContinous	ᎦᏙᎦ:Stand
ᏙᎦᏏ	Other	ᏙᎦᏏ:Moscovie duck
ᏙᎨᏍᏔ	Immediate	ᎦᏙᎦ:Stand
ᏙᎨᏍᏗ	Deverbal	ᎦᏙᎦ:Stand
ᏙᎨᏍᏛᎢ	RemotePast	ᎦᏙᎦ:Stand
ᏙᎩᏯᏍᏗ	Other	ᏙᎩᏯᏍᏗ:Asheville, N.C
ᏙᎪᎢ	Habitual	ᎦᏙᎦ:Stand
ᏙᎯᏥᏆ	Other	ᏙᎯᏥᏆ:Grass hopper
ᏙᎳᏗᏳᏍᏗ	Other	ᏙᎳᏗᏳᏍᏗ:Spiny amaranth
ᏙᎳᏥ	Other	ᏙᎳᏥ:Grass hopper
ᏙᎴᏓ	Other	ᏙᎴᏓ:Bear nettle
ᏙᏂ	Other	ᏙᏂ:Why
ᏙᏌ	Other	ᏙᏌ:Gnats
ᏙᏌᎾ	Other	ᏙᏌᎾ:Turnip
ᏙᏒᏓᎵ	Other	ᏙᏒᏓᎵ:Ant
ᏙᏓᏆᏍᎬᎢ	Other	ᏙᏓᏆᏍᎬᎢ:Sunday
ᏙᏓᏈᏕᏂ	Other	ᏙᏓᏈᏕᏂ:Saturday
ᏙᏓᏉᏅᎯ	Other	ᏙᏓᏉᏅᎯ:Monday
ᏙᏗ	Other	ᏙᏗ:Maybe
ᏙᏥ	Other	ᏙᏥ:White pine
ᏙᏥᏔᏅᎢ	RemotePast	ᎠᏙᏥᏗᎭ:Ridiculing
ᏙᏥᏗᎭ	PresentContinous	ᎠᏙᏥᏗᎭ:Ridiculing
ᏙᏥᏗᏍᎪᎢ	Habitual	ᎠᏙᏥᏗᎭ:Ridiculing
ᏙᏦᏗ	Deverbal	ᎠᏙᏥᏗᎭ:Ridiculing
ᏙᏧᏩ	Other	ᏙᏧᏩ:Red bird
ᏙᏫᏓ	Immediate	ᎦᏙᏫᏗᎭ:Mash
ᏙᏫᏔᏅᎢ	RemotePast	ᎦᏙᏫᏗᎭ:Mash
ᏙᏫᏗᎭ	PresentContinous	ᎦᏙᏫᏗᎭ:Mash
ᏙᏫᏗᏍᎪᎢ	Habitual	ᎦᏙᏫᏗᎭ:Mash
ᏙᏫᏙᏗ	Deverbal	ᎦᏙᏫᏗᎭ:Mash
ᏙᏯ	Other	ᏙᏯ:Genus: Castor Canadensis
ᏙᏱ	Other	ᏙᏱ:Outside
ᏙᏱᏨ	Other	ᏙᏱᏨ:Outside of
ᏙᏳᏂᏏ	Other	ᏙᏳᏂᏏ:Water beetle
ᏚᎥᎦ	Immediate	ᎤᏚᎦ:Owing someone
ᏚᎦ	PresentContinous	ᎤᏚᎦ:Owing someone	ᏓᏕᎦ:Placing long things into a row
ᏚᎪᎢ	Habitual	ᎤᏚᎦ:Owing someone
ᏚᎲᎦ	Immediate	ᏕᎦᏚᎲᏍᎦ:Baking bread
ᏚᎲᏍᎦ	PresentContinous	ᏕᎦᏚᎲᏍᎦ:Baking bread
ᏚᎲᏍᎪᎢ	Habitual	ᏕᎦᏚᎲᏍᎦ:Baking bread
ᏚᎵᎢᏍᏗ	Other	ᏚᎵᎢᏍᏗ:September
ᏚᎵᏍᏆᏗᏍᎬᎢ	Other	ᎤᎵᏍᏆᏗᏍᎬᎢ:Earache
ᏚᎵᏗᎾᎥᎢ	Other	ᏚᎵᏗᎾᎥᎢ:Family
ᏚᏂᏅᏗ	Other	ᏚᏂᏅᏗ:October
ᏚᏃᎸᏓᏂ	Other	ᏚᏃᎸᏓᏂ:January
ᏚᏅᎢ	RemotePast	ᎤᏚᎦ:Owing someone	ᏕᎦᏚᎲᏍᎦ:Baking bread
ᏚᏇᏍᏗ	Other	ᏚᏇᏍᏗ:Blow gun
ᏚᏗ	Deverbal	ᏕᎦᏚᎲᏍᎦ:Baking bread	ᎤᏚᎦ:Owing someone
ᏚᏘ	Other	ᏚᏘ:Snowbird
ᏚᏘᏱ	Other	ᏚᏘᏱ:Snowbird Community
ᏚᏪᎧ	Other	ᏚᏪᎧ:Salamander
ᏚᏫᏍᎦᎵ	Other	ᏚᏫᏍᎦᎵ:Flint
ᏚᏬᎵ	Other	ᏚᏬᎵ:Stopper
ᏚᏯ	Other	ᏚᏯ:Genus: All Varieties
ᏚᏯᏁᏆ	Other	ᏚᏯᏁᏆ:Lima or butter beans
ᏚᏯᏍᏗ	Other	ᏚᏯᏍᏗ:Jack-in-the-pulpit
ᏚᏰᏑᎧᎸᎢ	Other	ᎤᏰᏑᎧᎸᎢ:Fingernail
ᏚᏰᏑᏨᏂ	Other	ᎤᏰᏑᏨᏂ:Wrist
ᏚᏳᎦᏔ	Other	ᏚᏳᎦᏔ:Proper
ᏛᎢ	RemotePast	ᎠᏗᎠ:Placing something long on the ground
ᏛᎧ	Other	ᏛᎧ:Housefly
ᏛᎬᎾ	Other	ᏛᎬᎾ:Oyster
ᏛᏗᏍᏗ	Other	ᏛᏗᏍᏗ:Ruffed grouse
ᏛᏰᏆ	Other	ᏛᏰᏆ:Genus: Anguilla Rostrata
Ꮳ	Immediate	ᎠᏥᎠ:Putting something liquid into it
ᏣᎦ	Immediate	ᎠᏣᎦᏍᎦ:Mowing
ᏣᎦᎦ	Immediate	ᎠᏣᎦᏍᎦ:Cutting weeds
ᏣᎦᏍᎦ	PresentContinous	ᎠᏣᎦᏍᎦ:Cutting weeds
ᏣᎦᏍᎪᎢ	Habitual	ᎠᏣᎦᏍᎦ:Cutting weeds
ᏣᎦᏍᏗ	Deverbal	ᎠᏣᎦᏍᎦ:Cutting weeds
ᏣᎦᏒᎢ	RemotePast	ᎠᏣᎦᏍᎦ:Mowing
ᏣᎦᏱ	Other	ᏣᎦᏱ:Yellow jacket
ᏣᎵᏍᏙᏂ	Other	ᏣᎵᏍᏙᏂ:Bryson City, North Carolina
ᏣᎶᎯ	Other	ᏣᎶᎯ:Kingfisher
ᏣᎹᎭ	Other	ᏣᎹᎭ:Genus: Family Vespertilionidae
ᏣᏁᎳ	Other	ᏣᏁᎳ:Eight
ᏣᏁᏅ	Other	ᏣᏁᏅ:Skink
ᏣᏃ	Other	ᏣᏃ:No
ᏣᏃᏏ	Other	ᏣᏃᏏ:Rhino
ᏣᏄᎵᏓ	Immediate	ᎠᏣᏄᎵᏗᎠ:Speeding it up
ᏣᏄᎵᏗᎠ	PresentContinous	ᎠᏣᏄᎵᏗᎠ:Speeding it up
ᏣᏄᎵᏗᏍᎪᎢ	Habitual	ᎠᏣᏄᎵᏗᎠ:Speeding it up
ᏣᏄᎵᏗᏍᏗ	Deverbal	ᎠᏣᏄᎵᏗᎠ:Speeding it up
ᏣᏄᎵᏛᎢ	RemotePast	ᎠᏣᏄᎵᏗᎠ:Speeding it up
ᏣᏄᏏ	Other	ᏣᏄᏏ:Leech
ᏣᏉᎳᏕ	Other	ᏣᏉᎳᏕ:Genus: Sialia Sialis
ᏣᏓᏄᎩ	Other	ᏣᏓᏄᎩ:Chattanooga
ᏣᏥᏯ	Other	ᏣᏥᏯ:Georgia
ᏣᏱᎦ	Other	ᏣᏱᎦ:Genus: Cyanocitta Crisiata
ᏣᏲᎭᎦ	Immediate	ᎠᏣᏲᎵᎭ:Sticking it
ᏣᏲᎯᎭ	PresentContinous	ᎦᏣᏲᎯᎭ:Stabbing him
ᏣᏲᎯᎰᎢ	Habitual	ᎦᏣᏲᎯᎭ:Stabbing him
ᏣᏲᎵᎭ	PresentContinous	ᎠᏣᏲᎵᎭ:Sticking it
ᏣᏲᎵᎰᎢ	Habitual	ᎠᏣᏲᎵᎭ:Sticking it
ᏣᏲᎵᎸᎢ	RemotePast	ᎠᏣᏲᎵᎭ:Sticking it
ᏣᏲᎸᎢ	RemotePast	ᎦᏣᏲᎯᎭ:Stabbing him
ᏣᏲᏍᏗ	Deverbal	ᎠᏣᏲᎵᎭ:Sticking it	ᎦᏣᏲᎯᎭ:Stabbing him
ᏤᏤᎭ	PresentContinous	ᎠᏤᏤᎭ:Taking revenge on
ᏤᏤᎰᎢ	Habitual	ᎠᏤᏤᎭ:Taking revenge on
ᏤᏤᎸᎢ	RemotePast	ᎠᏤᏤᎭ:Taking revenge on
ᏤᏤᏗ	Deverbal	ᎠᏤᏤᎭ:Taking revenge on
ᏥᎠ	PresentContinous	ᎠᏥᎠ:Putting something liquid into it
ᏥᎦᎷᎢ	Other	ᎦᎦᎷᎢ:Thigh
ᏥᎦᏆᎴᏂ	Other	ᎦᎦᏆᎴᏂ:Cheek
ᏥᎦᏍᎬᏂᏓ	Other	ᎠᎦᏍᎬᏂᏓ:Left-handed
ᏥᎦᏙᎵ	Other	ᎠᎦᏙᎵ:Eye
ᏥᎦᏣ	Other	ᏥᎦᏣ:Song sparrow
ᏥᎦᏴᎵᎨᎢ	Other	ᎠᎦᏴᎵᎨᎢ:Woman, elderly
ᏥᎧᏅᎢ	Other	ᎠᎧᏅᎢ:Eye
ᏥᎧᏍᎨᏂ	Other	ᎠᎧᏍᎨᏂ:Hip
ᏥᎨᏯ	Other	ᎠᎨᏯ:Woman
ᏥᎩᎩ	Other	ᏥᎩᎩ:Katydid
ᏥᎩᎵ	Other	ᏥᎩᎵ:Night traveler
ᏥᎩᎵᎨᏂ	Other	ᎦᎩᎵᎨᏂ:Neck (back of)
ᏥᎩᎵᎵ	Other	ᏥᎩᎵᎵ:Genus: Parus Carolinensis
ᏥᎪᏱ	Other	ᏥᎪᏱ:Worm
ᏥᎪᏱᏙᏍᏗ	Other	ᏥᎪᏱᏙᏍᏗ:Pee wee (bird)
ᏥᎫᏍᎨᏂ	Other	ᎠᎫᏍᎨᏂ:Elbow
ᏥᎬᏗᎨᏂ	Other	ᎠᎬᏗᎨᏂ:Forehead
ᏥᎰᎵ	Other	ᎠᎰᎵ:Mouth
ᏥᎴᏂ	Other	ᎦᎴᏂ:Ear
ᏥᎵᏦᎯᏓ	Other	ᎦᎵᏦᎯᏓ:Fat
ᏥᎸᏙᎵ	Other	ᎦᎸᏙᎵ:Tall and skinny
ᏥᎾᎩᎸᎢ	Other	ᎦᎾᎩᎸᎢ:House
ᏥᎾᏌᏛᎢ	Other	ᎦᎾᏌᏛᎢ:Toe
ᏥᎾᏫᎯ	Other	ᎦᎾᏫᎯ:Heart
ᏥᏁᎳᏗ	Other	ᎦᏁᎳᏗ:Pregnant
ᏥᏁᏥᎢ	Other	ᎦᏁᏥᎢ:Chest (of the body)
ᏥᏂᎨᏂ	Other	ᎦᏂᎨᏂ:Knee
ᏥᏂᎪᎢ	Other	ᎦᏂᎪᎢ:Tongue
ᏥᏃᎨᏂ	Other	ᎦᏃᎨᏂ:Arm
ᏥᏄᎳᏥᏴᎢ	Other	ᎠᏄᎳᏥᏴᎢ:Ribs
ᏥᏅᎢ	RemotePast	ᎠᏥᎠ:Putting something liquid into a container
ᏥᏅᏍᎨᏂ	Other	ᎦᏅᏍᎨᏂ:Leg
ᏥᏅᏒᏨᎢ	Other	ᎦᏅᏒᏨᎢ:Ankle
ᏥᏅᏙᎧ	Other	ᎦᏅᏙᎧ:Tooth
ᏥᏍᎦᏯ	Other	ᎠᏍᎦᏯ:Man
ᏥᏍᎨᏂ	Other	ᎦᏍᎨᏂ:Armpit
ᏥᏍᎪᎢ	Habitual	ᎠᏥᎠ:Putting something liquid into a container
ᏥᏍᎪᎩᎵ	Other	ᏥᏍᎪᎩᎵ:Crayfish, red
ᏥᏍᎪᎵ	Other	ᎠᏍᎪᎵ:Head
ᏥᏍᎬᏓᎨᏂ	Other	ᎠᏍᎬᏓᎨᏂ:Shin bone
ᏥᏍᏆ	Other	ᏥᏍᏆ:Bird
ᏥᏍᏆᎦᏬᏂᏍᎩ	Other	ᏥᏍᏆᎦᏬᏂᏍᎩ:Parrot
ᏥᏍᏆᎨᏂ	Other	ᎠᏍᏆᎨᏂ:Side of a person's body
ᏥᏍᏆᎸᎾ	Other	ᏥᏍᏆᎸᎾ:Humblehead (fish)
ᏥᏍᏆᏁᎦᎸᎢ	Other	ᎠᏍᏆᏁᎦᎸᎢ:Abdomen
ᏥᏍᏆᏯ	Other	ᏥᏍᏆᏯ:Sparrow
ᏥᏍᏇᏄᏨ	Other	ᏥᏍᏇᏄᏨ:Genus: Dendrocopus Pubescens
ᏥᏍᏈᏍᏓ	Other	ᏥᏍᏈᏍᏓ:Many
ᏥᏍᏉᎯ	Other	ᏥᏍᏉᎯ:Birdtown
ᏥᏍᏉᏉ	Other	ᏥᏍᏉᏉ:Robin
ᏥᏍᏓᎨᏂ	Other	ᎦᏍᏓᎨᏂ:Calf of the leg
ᏥᏍᏓᎳᎦ	Immediate	ᎠᏥᏍᏓᎳᏍᎦ:Igniting it
ᏥᏍᏓᎳᏅᎢ	RemotePast	ᎠᏥᏍᏓᎳᏍᎦ:Igniting it
ᏥᏍᏓᎳᏍᎦ	PresentContinous	ᎠᏥᏍᏓᎳᏍᎦ:Igniting it
ᏥᏍᏓᎳᏍᎪᎢ	Habitual	ᎠᏥᏍᏓᎳᏍᎦ:Igniting it
ᏥᏍᏓᎶᏗ	Deverbal	ᎠᏥᏍᏓᎳᏍᎦ:Igniting it
ᏥᏍᏕᏥ	Other	ᏥᏍᏕᏥ:Rat
ᏥᏍᏗ	Deverbal	ᎠᏥᎠ:Putting something liquid into it
ᏥᏍᏚ	Other	ᏥᏍᏚ:Rabbit
ᏥᏍᏛᎾ	Other	ᏥᏍᏛᎾ:Crayfish, green
ᏥᏐᎯᎢ	Other	ᎦᏐᎯᎢ:Upper back
ᏥᏓᎦ	Other	ᏥᏓᎦ:Genus: Gallus Gallus
ᏥᏓᎳᏓ	Immediate	ᎤᏥᏓᎳᏗᎠ:Has a sore
ᏥᏓᎳᏗᎠ	PresentContinous	ᎤᏥᏓᎳᏗᎠ:Has a sore
ᏥᏓᎳᏗᏍᎪᎢ	Habitual	ᎤᏥᏓᎳᏗᎠ:Has a sore
ᏥᏓᎳᏗᏍᏗ	Deverbal	ᎤᏥᏓᎳᏗᎠ:Has a sore
ᏥᏓᎳᏛᎢ	RemotePast	ᎤᏥᏓᎳᏗᎠ:Has a sore
ᏥᏖᏍᎨᏂ	Other	ᎦᏖᏍᎨᏂ:Back, lower (body pt)	ᎠᏖᏍᎨᏂ:Lower back
ᏥᏗᎨᏂ	Other	ᎦᏗᎨᏂ:Heel (of foot)
ᏥᏘᏍᎩ	Other	ᎠᏘᏍᎩ:Right-handed
ᏥᏚᎥᏍᎦ	PresentContinous	ᎠᏥᏚᎥᏍᎦ:Flirting with
ᏥᏚᎥᏍᎪᎢ	Habitual	ᎠᏥᏚᎥᏍᎦ:Flirting with
ᏥᏚᏅᎢ	RemotePast	ᎠᏥᏚᎥᏍᎦ:Flirting with
ᏥᏚᏗ	Deverbal	ᎠᏥᏚᎥᏍᎦ:Flirting with
ᏥᏥ	Other	ᏥᏥ:Scottish thistle
ᏥᏧᏣ	Other	ᎠᏧᏣ:Boy
ᏥᏯᏍᎨᏂ	Other	ᎠᏯᏍᎨᏂ:Crown of the head
ᏥᏰᎸᎢ	Other	ᎠᏰᎸᎢ:Body
ᏥᏰᏌᏛᎢ	Other	ᎠᏰᏌᏛᎢ:Finger
ᏥᏲ	Other	ᏥᏲ:Otter
ᏥᏲᎯ	Other	ᏥᏲᎯ:Robbinsville
ᏥᏲᎵ	Other	ᎠᏲᎵ:Child
ᏥᏲᏣ	Other	ᎠᏲᏣ:Girl, preteen
ᏥᏳ	Other	ᏥᏳ:Yellow poplar
ᏥᏳᎨᏂ	Other	ᎠᏳᎨᏂ:Chin
ᏥᏳᎪᎢ	Other	ᎠᏳᎪᎢ:Jaw
ᏥᏴᏐᎵ	Other	ᎠᏴᏐᎵ:Nose
ᏥᏴᏤᏂ	Other	ᎠᏴᏤᏂ:Neck, front of
ᏥᏴᏫᏯ	Other	ᎠᏴᏫᏯ:Native American
ᏦᎢ	Other	ᏦᎢ:Three
ᏦᎣᏍᎪᎯ	Other	ᏦᎣᏍᎪᎯ:Thirty
ᏦᎥᏍᏓ	Immediate	ᎠᏦᎥᏍᏗᎭ:Running over him
ᏦᎥᏍᏔᏅᎢ	RemotePast	ᎠᏦᎥᏍᏗᎭ:Running over him
ᏦᎥᏍᏗᎭ	PresentContinous	ᎠᏦᎥᏍᏗᎭ:Running over him
ᏦᎥᏍᏗᏍᎪᎢ	Habitual	ᎠᏦᎥᏍᏗᎭ:Running over him
ᏦᎥᏍᏙᏗ	Deverbal	ᎠᏦᎥᏍᏗᎭ:Running over him
ᏦᎦᏚᎯ	Other	ᏦᎦᏚᎯ:Thirteen
ᏦᎨᏏ	Other	ᏦᎨᏏ:Field
ᏦᎩ	Other	ᏦᎩ:Upstream
ᏦᎳ	Other	ᏦᎳ:Scarlet tanger
ᏦᎳᏂ	Other	ᏦᎳᏂ:Window pane
ᏦᏍᏓᎵᏅᏥ	Other	ᏦᏍᏓᎵᏅᏥ:Brothers, we are
ᏦᏖᎥᎢ	RemotePast	ᎠᏦᏖᎭ:Blowing on someone
ᏦᏖᎭ	PresentContinous	ᎠᏦᏖᎭ:Blowing on someone
ᏦᏖᎰᎢ	Habitual	ᎠᏦᏖᎭ:Blowing on someone
ᏦᏖᏗ	Deverbal	ᎠᏦᏖᎭ:Blowing on someone
ᏦᏯᎦ	Other	ᏦᏯᎦ:Genus: Riparia Riparia
ᏧᎦᏃᏅ	Other	ᏧᎦᏃᏅ:Genus: Fraxinus L
ᏧᎦᏃᏮᎢ	Other	ᏧᎦᏃᏮᎢ:South
ᏧᎦᏅᏍᏓᎵ	Other	ᏧᎦᏅᏍᏓᎵ:Bull
ᏧᎦᏍᏆᎾᎩᏓ	Other	ᏧᎦᏍᏆᎾᎩᏓ:Goat
ᏧᎧ	Other	ᏧᎧ:Genus: Order Siphonaptera
ᏧᎩᏅ	Other	ᏧᎩᏅ:Genus: Ulmus Sp
ᏧᎪᏅ	Other	ᎤᎪᏅ:Testicle
ᏧᎬᏩᎶᏗ	Other	ᏧᎬᏩᎶᏗ:Worth
ᏧᎯᏥᏆ	Other	ᏧᎯᏥᏆ:Twisted stalk
ᏧᎳ	Other	ᏧᎳ:Genus: Vulpes Sp
ᏧᎳᏍᎩ	Other	ᏧᎳᏍᎩ:Iron pot
ᏧᎵᎡᎾ	Other	ᏧᎵᎡᎾ:Yellow bellied sapsucker
ᏧᎵᎡᏂ	Other	ᏧᎵᎡᏂ:Deaf (in both hears)
ᏧᎵᏍᏓᎾᎵ	Other	ᏧᎵᏍᏓᎾᎵ:Genus: Ictacurus Sp
ᏧᎾᏥᎠᏙᎯ	Other	ᏧᎾᏥᎠᏙᎯ:Ear rings
ᏧᏁᎸᏗ	Other	ᏧᏁᎸᏗ:Christian
ᏧᏂᎩᎶᏍᏗ	Other	ᏧᏂᎩᎶᏍᏗ:Friday
ᏧᏂᎩᏥᏴᏍᏗ	Other	ᏧᏂᎩᏥᏴᏍᏗ:Mud flutter fish
ᏧᏂᎶᎩ	Other	ᏧᏂᎶᎩ:Slicky mushroom
ᏧᏂᎶᎸᏗ	Other	ᏧᏂᎶᎸᏗ:Rainbow trout
ᏧᏂᎶᏇ	Other	ᏧᏂᎶᏇ:Slicky mushroom
ᏧᏂᏦᏍᏗ	Other	ᏧᏂᏦᏍᏗ:Sour
ᏧᏂᏦᏴᏍᏗ	Other	ᏧᏂᏦᏴᏍᏗ:Rhubarb
ᏧᏃᏪᎶᏗᏳ	Other	ᏧᏃᏪᎶᏗᏳ:Office
ᏧᏅᏌᏗ	Other	ᎤᏅᏌᏗ:Rattle wrapped around the leg
ᏧᏆᏆ	Other	ᏧᏆᏆ:Red buckeye
ᏧᏍᎪ	Other	ᏧᏍᎪ:Post oak
ᏧᏍᏓᏱ	Other	ᏧᏍᏓᏱ:Hard corn (past roasting stage)
ᏧᏔᎾᎶ	Other	ᏧᏔᎾᎶ:Bridle
ᏧᏕᎩ	Other	ᏧᏕᎩ:Pitcher (baseball)
ᏧᏕᏒᎾᎵ	Other	ᏧᏕᏒᎾᎵ:Vireo (plant)
ᏧᏗᏆᏅᏥ	Other	ᏧᏗᏆᏅᏥ:Genus: Hirundo Erythrugast
ᏧᏗᏆᏍᏗ	Other	ᏧᏗᏆᏍᏗ:Peacock
ᏧᏚᎶᏗ	Other	ᏧᏚᎶᏗ:Split lip
ᏧᏛᏃᎯᏛ	Other	ᏧᏛᏃᎯᏛ:Sheets
ᏧᏤᏲᏍᏗ	Other	ᏧᏤᏲᏍᏗ:Sticky
ᏧᏦᎵᏛ	Other	ᏧᏦᎵᏛ:Oven bird
ᏧᏧ	Other	ᏧᏧ:Purple martin
ᏧᏩ	Other	ᏧᏩ:Waterdog
ᏧᏩᎩ	Other	ᏧᏩᎩ:Maple
ᏧᏩᏂᎨᎢ	Other	ᏧᏩᏂᎨᎢ:Soft corn (roasting stage)
ᏧᏩᏚᏂ	Other	ᏧᏩᏚᏂ:Veins
ᏧᏪᏅᏒᎢ	Other	ᎤᏪᏅᏒᎢ:Home
ᏧᏪᏥ	Other	ᎤᏪᏥ:Offspring
ᏧᏬᏍᎦ	Other	ᏧᏬᏍᎦ:Towhee
ᏧᏲᏂ	Other	ᏧᏲᏂ:Antlers
ᏧᏴᏨᎢ	Other	ᏧᏴᏨᎢ:North
ᏨᎢ	RemotePast	ᎠᏥᎠ:Putting something liquid into it
ᏨᎢᏍᏗ	Deverbal	ᎤᏨᎦ:Sick
ᏨᎥᎠ	Immediate	ᎠᏨᎥᏍᎦ:Pouring
ᏨᎥᎢᏍᏗ	Deverbal	ᎠᏨᎥᏍᎦ:Pouring
ᏨᎥᎥᎢ	RemotePast	ᎠᏨᎥᏍᎦ:Pouring
ᏨᎥᎦ	Immediate	ᎠᏨᎥᏍᎦ:Spilling something liquid
ᏨᎥᏍᎦ	PresentContinous	ᎠᏨᎥᏍᎦ:Pouring
ᏨᎥᏍᎪᎢ	Habitual	ᎠᏨᎥᏍᎦ:Pouring it out
ᏨᎦ	PresentContinous	ᎤᏨᎦ:Sick
ᏨᎪᎢ	Habitual	ᎤᏨᎦ:Sick
ᏨᏅᎢ	RemotePast	ᎠᏨᎥᏍᎦ:Pouring it out
ᏨᏍᏔᎦ	Immediate	ᎠᏨᏍᏔᏍᎦ:Turning on a light	ᏓᏨᏍᏔᏍᎦ:Turning on a light
ᏨᏍᏔᏅᎢ	RemotePast	ᎠᏨᏍᏔᏍᎦ:Turning on a light	ᏓᏨᏍᏔᏍᎦ:Turning on a light
ᏨᏍᏔᏍᎦ	PresentContinous	ᏓᏨᏍᏔᏍᎦ:Turning on a light	ᎠᏨᏍᏔᏍᎦ:Turning on a light
ᏨᏍᏔᏍᎪᎢ	Habitual	ᏓᏨᏍᏔᏍᎦ:Turning on a light	ᎠᏨᏍᏔᏍᎦ:Turning on a light
ᏨᏍᏔᏗ	Deverbal	ᏓᏨᏍᏔᏍᎦ:Turning on a light
ᏨᏍᏙᏗ	Deverbal	ᎠᏨᏍᏔᏍᎦ:Turning on a light
ᏨᏓᏥ	Other	ᏨᏓᏥ:Panther
ᏨᏗ	Deverbal	ᎠᏨᎥᏍᎦ:Pouring out
ᏨᏨᎢ	RemotePast	ᎤᏨᎦ:Sick
ᏨᏩᏍᏓ	Immediate	ᎠᏨᏩᏍᏗᎭ:Wringing it
ᏨᏩᏍᏔᏅᎢ	RemotePast	ᎠᏨᏩᏍᏗᎭ:Wringing it
ᏨᏩᏍᏗᎭ	PresentContinous	ᎠᏨᏩᏍᏗᎭ:Wringing it
ᏨᏩᏍᏗᏍᎪᎢ	Habitual	ᎠᏨᏩᏍᏗᎭ:Wringing it
ᏨᏩᏍᏙᏗ	Deverbal	ᎠᏨᏩᏍᏗᎭ:Wringing it
ᏨᏯᎲᎢ	RemotePast	ᎦᏨᏯᏍᎦ:Stinging him
ᏨᏯᏍᎦ	PresentContinous	ᎦᏨᏯᏍᎦ:Stinging him
ᏨᏯᏍᎪᎢ	Habitual	ᎦᏨᏯᏍᎦ:Stinging him
ᏨᏱᏍᏗ	Deverbal	ᎦᏨᏯᏍᎦ:Stinging him
Ꮹ	Immediate	ᏂᎦᏪᎠ:Saying again	ᎠᏫᏍᎦ:Planting
ᏩᎧ	Other	ᏩᎧ:Cow (Spanish Borrowing)
ᏩᎩᎦ	Other	ᏩᎩᎦ:Squash
ᏩᎫᎵ	Other	ᏩᎫᎵ:Whipperwill
ᏩᎭ	Immediate	ᎤᏩᏍᎦ:Buying it
ᏩᎯᏍᏗ	Deverbal	ᎤᏩᏍᎦ:Buying it
ᏩᎱᎱ	Other	ᏩᎱᎱ:Screech owl
ᏩᎴᎳ	Other	ᏩᎴᎳ:Hummingbird
ᏩᎶᏏ	Other	ᏩᎶᏏ:Warts
ᏩᎾ	Other	ᏩᎾ:Soft
ᏩᏁᎢ	Other	ᏩᏁᎢ:Hickory
ᏩᏁᎩᏓ	Other	ᏩᏁᎩᏓ:Genus: Ligusticum Canadense
ᏩᏍᎦ	PresentContinous	ᎤᏩᏍᎦ:Buying it
ᏩᏍᎪᎢ	Habitual	ᎤᏩᏍᎦ:Buying it
ᏩᏍᏗ	Deverbal	ᎠᏯᎠ:Inside
ᏩᏒᎢ	RemotePast	ᎤᏩᏍᎦ:Buying it
ᏩᏒᎥᎦ	Immediate	ᎤᏩᏒᎥᏍᎦ:Buying things
ᏩᏒᎥᏍᎦ	PresentContinous	ᎤᏩᏒᎥᏍᎦ:Buying things
ᏩᏒᎥᏍᎪᎢ	Habitual	ᎤᏩᏒᎥᏍᎦ:Buying things
ᏩᏒᎦ	Immediate	ᎤᏩᏩᏒᎦ:Smelling it
ᏩᏒᎭᎭ	Immediate	ᎠᏩᏒᎭᏍᎦ:Whistling
ᏩᏒᎭᏍᎦ	PresentContinous	ᎠᏩᏒᎭᏍᎦ:Whistling
ᏩᏒᎭᏍᎪᎢ	Habitual	ᎠᏩᏒᎭᏍᎦ:Whistling
ᏩᏒᏅᎢ	RemotePast	ᎤᏩᏒᎥᏍᎦ:Buying things
ᏩᏒᏗ	Deverbal	ᎤᏩᏒᎥᏍᎦ:Buying things
ᏩᏓ	Other	ᏩᏓ:Thanks
ᏩᏓᎬ	Other	ᏩᏓᎬ:Gold finch
ᏩᏔ	Immediate	ᎠᏩᏘᎭ:Finding something solid
ᏩᏘᎭ	PresentContinous	ᎠᏩᏘᎭ:Finding something solid
ᏩᏘᏍᎪᎢ	Habitual	ᎠᏩᏘᎭ:Finding something solid
ᏩᏘᏰᎵ	Other	ᏩᏘᏰᎵ:Magpie
ᏩᏚᎵᏏ	Other	ᏩᏚᎵᏏ:Honey
ᏩᏚᏰᎳ	Other	ᏩᏚᏰᎳ:Imitator Bird
ᏩᏛᎮᏒᎢ	RemotePast	ᎠᏩᏛᎯ:Going to go visit someone
ᏩᏛᎯ	PresentContinous	ᎠᏩᏛᎯ:Going to go visit someone
ᏩᏛᎯᏐᎢ	Habitual	ᎠᏩᏛᎯ:Going to go visit someone
ᏩᏛᎯᏓᏍᏗ	Deverbal	ᎠᏩᏛᎯᏙᎭ:Visiting
ᏩᏛᎯᏙᎠ	Immediate	ᎠᏩᏛᎯᏙᎭ:Visiting
ᏩᏛᎯᏙᎭ	PresentContinous	ᎠᏩᏛᎯᏙᎭ:Visiting
ᏩᏛᎯᏙᎰᎢ	Habitual	ᎠᏩᏛᎯᏙᎭ:Visiting
ᏩᏛᎯᏙᎸᎢ	RemotePast	ᎠᏩᏛᎯᏙᎭ:Visiting
ᏩᏛᎱᎦ	Immediate	ᎠᏩᏛᎯ:Going to go visit someone
ᏩᏛᎲᎢ	RemotePast	ᎠᏩᏘᎭ:Finding something solid
ᏩᏛᎲᏍᏗ	Deverbal	ᎠᏩᏛᎯ:Going to go visit someone
ᏩᏛᏗ	Deverbal	ᎠᏩᏘᎭ:Finding something solid
ᏩᏥ	Other	ᏩᏥ:Wristwatch (English Borrowing)
ᏩᏥᎦ	Other	ᏩᏥᎦ:Green amaranth
ᏩᏥᏂ	Other	ᏩᏥᏂ:Virginia
ᏩᏩᏒᎢᏍᏗ	Deverbal	ᎤᏩᏩᏒᎦ:Smelling it
ᏩᏩᏒᎦ	PresentContinous	ᎤᏩᏩᏒᎦ:Smelling it
ᏩᏩᏒᎪᎢ	Habitual	ᎤᏩᏩᏒᎦ:Smelling it
ᏩᏩᏒᎭᎲᎢ	RemotePast	ᎠᏩᏒᎭᏍᎦ:Whistling
ᏩᏩᏒᎭᏍᏗ	Deverbal	ᎠᏩᏒᎭᏍᎦ:Whistling
ᏩᏩᏒᏨᎢ	RemotePast	ᎤᏩᏩᏒᎦ:Smelling it
ᏩᏯ	Other	ᏩᏯ:Wolf
ᏩᏲᎯ	Other	ᏩᏲᎯ:Wolftown
ᏪᎠ	PresentContinous	ᏂᎦᏪᎠ:Saying again
ᏪᏌ	Other	ᏪᏌ:Genus: Felix Domestica
ᏪᏍᎪᎢ	Habitual	ᏂᎦᏪᎠ:Saying again
ᏪᏒᎢ	RemotePast	ᏂᎦᏪᎠ:Saying again
ᏫᎭ	Immediate	ᏓᏫᏍᎦ:Planting seeds
ᏫᏍᎦ	PresentContinous	ᎠᏫᏍᎦ:Planting	ᏓᏫᏍᎦ:Planting seeds
ᏫᏍᎩ	Other	ᏫᏍᎩ:Whiskey (english borrowing)
ᏫᏍᎪᎢ	Habitual	ᎠᏫᏍᎦ:Planting	ᏓᏫᏍᎦ:Planting seeds
ᏫᏍᏗ	Deverbal	ᎠᏫᏍᎦ:Planting	ᏓᏫᏍᎦ:Planting seeds
ᏫᏏ	Other	ᏫᏏ:Wishi mushroom
ᏫᏒᎢ	RemotePast	ᎠᏫᏍᎦ:Planting	ᏓᏫᏍᎦ:Planting seeds
ᏫᏓ	Immediate	ᎠᏫᏗᎭ:Carrying something solid off
ᏫᏗᎭ	PresentContinous	ᎠᏫᏗᎭ:Carrying something solid off
ᏫᏗᏍᎪᎢ	Habitual	ᎠᏫᏗᎭ:Carrying something solid off
ᏫᏘᏗ	Deverbal	ᎠᏫᏗᎭ:Carrying something solid off
ᏫᏛᎲᎢ	RemotePast	ᎠᏫᏗᎭ:Carrying something solid off
ᏫᏥᎨᏆ	Other	ᏫᏥᎨᏆ:Bigger
ᏫᏥᏄᏬᏚᎭ	Other	ᏫᏥᏄᏬᏚᎭ:Prettiest
ᏬᏂᎭ	Immediate	ᎦᏬᏂᎭ:Talking
ᏬᏂᎯᏍᏗ	Deverbal	ᎦᏬᏂᎭ:Talking
ᏬᏂᏍᎪᎢ	Habitual	ᎦᏬᏂᎭ:Talking
ᏬᏂᏒᎢ	RemotePast	ᎦᏬᏂᎭ:Talking
ᏬᏗ	Other	ᏬᏗ:Indian Paint
ᏬᏗᎨᎠᏍᎪᎵ	Other	ᏬᏗᎨᎠᏍᎪᎵ:Genus: Agkistrodon Cowtortr
ᏬᏗᎨᎢ	Other	ᏬᏗᎨᎢ:Brown
ᏬᏰ	Other	ᏬᏰ:Foul ball (stickball)
ᏬᏱ	Other	ᏬᏱ:Passenger pigeon
ᏭᏕᎵ	Other	ᏭᏕᎵ:Out of sight
ᏭᏕᎵᎬ	Other	ᏭᏕᎵᎬ:Oklahoma
ᏭᏕᎵᎬᎢ	Other	ᏭᏕᎵᎬᎢ:West
Ꮿ	Immediate	ᎠᏱᎠ:Picking up something long from the ground	ᎠᏯ:Picking up something long
ᏯᎠ	PresentContinous	ᎠᏯᎠ:Inside
ᏯᎡᏍᏔ	Immediate	ᎠᏯᎠ:Inside
ᏯᎡᏍᏛᎢ	RemotePast	ᎠᏯᎠ:Inside
ᏯᎣᎢ	Habitual	ᎠᏯᎠ:Inside
ᏯᎦ	Immediate	ᎠᏯᎩᎠ:Eating something flexible
ᏯᎧᎥᎾ	Immediate	ᎠᎧᎲᎠ:Moving something alive
ᏯᎨᎦᏍᎦ	PresentContinous	ᏓᏯᎨᎦᏍᎦ:Peeling
ᏯᎨᎦᏍᎪᎢ	Habitual	ᏓᏯᎨᎦᏍᎦ:Peeling
ᏯᎨᎦᏍᏗ	Deverbal	ᏓᏯᎨᎦᏍᎦ:Peeling
ᏯᎨᎦᏒᎢ	RemotePast	ᏓᏯᎨᎦᏍᎦ:Peeling
ᏯᎨᎦᏣ	Immediate	ᏓᏯᎨᎦᏍᎦ:Peeling
ᏯᎩᎠ	PresentContinous	ᎠᏯᎩᎠ:Eating something flexible
ᏯᎩᎥᎢ	RemotePast	ᎠᏯᎩᎠ:Eating something flexible
ᏯᎩᏍᎪᎢ	Habitual	ᎠᏯᎩᎠ:Eating something flexible
ᏯᎩᏍᏗ	Deverbal	ᎠᏯᎩᎠ:Eating something flexible
ᏯᎪᏍᎩᏍᏓ	Immediate	ᎠᎪᏍᎩᏍᏗᎭ:Elbowing
ᏯᎵ	PresentContinous	ᎤᏯᎵ:Looking for
ᏯᎵᎡᎵᏥᏌ	Immediate	ᎠᎵᎮᎵᏤᎭ:Thanking him
ᏯᎵᎦ	Immediate	ᎤᏯᎵ:Looking for
ᏯᎵᎪᎥᏌ	Immediate	ᎠᎵᎪᏁᎭ:Wishing to accompany
ᏯᎵᏃᎮᏓ	Immediate	ᎠᎵᏃᎮᏗᎭ:Speaking to him
ᏯᎵᏌᎳ	Immediate	ᎠᎵᏌᎵᎭ:Teasing him
ᏯᎵᏐᎢ	Habitual	ᎤᏯᎵ:Looking for
ᏯᎶᏔ	Immediate	ᎤᏯᎶᏘᎭ:Overeating
ᏯᎶᏔᏅᎢ	RemotePast	ᎤᏯᎶᏘᎭ:Overeating
ᏯᎶᏕᎦ	Immediate	ᎠᎶᏕᎯᎭ:Kicking
ᏯᎶᏘᎭ	PresentContinous	ᎤᏯᎶᏘᎭ:Overeating
ᏯᎶᏘᏍᎪᎢ	Habitual	ᎤᏯᎶᏘᎭ:Overeating
ᏯᎶᏙᏗ	Deverbal	ᎤᏯᎶᏘᎭ:Overeating
ᏯᎸᎢ	RemotePast	ᎤᏯᎵ:Looking for
ᏯᎸᎥᎦ	Immediate	ᎦᏯᎸᏅᎦ:Stuck to it	ᎠᏯᎸᎥᏍᎦ:Sticking it to it
ᏯᎸᎥᏍᎦ	PresentContinous	ᎠᏯᎸᎥᏍᎦ:Sticking it to it
ᏯᎸᎥᏍᎪᎢ	Habitual	ᎠᏯᎸᎥᏍᎦ:Sticking it to it
ᏯᎸᏅᎢ	RemotePast	ᎠᏯᎸᎥᏍᎦ:Sticking it to it
ᏯᎸᏅᎦ	PresentContinous	ᎦᏯᎸᏅᎦ:Stuck to it
ᏯᎸᏅᎪᎢ	Habitual	ᎦᏯᎸᏅᎦ:Stuck to it
ᏯᎸᏅᏗ	Deverbal	ᎦᏯᎸᏅᎦ:Stuck to it
ᏯᎸᏅᏨᎢ	RemotePast	ᎦᏯᎸᏅᎦ:Stuck to it
ᏯᎸᏗ	Deverbal	ᎠᏯᎸᎥᏍᎦ:Sticking it to it
ᏯᎾ	Immediate	ᎠᏯᏂᎭ:Calling out for him	ᏩᏯᏂᎭ:Distance calling out for him (in the)
ᏯᏂᎭ	PresentContinous	ᎠᏯᏂᎭ:Calling out for him	ᏩᏯᏂᎭ:Distance calling out for him (in the)
ᏯᏂᏍᎪᎢ	Habitual	ᏩᏯᏂᎭ:Distance calling out for him (in the)	ᎠᏯᏂᎭ:Calling out for him
ᏯᏄᎩᏣᎦ	Immediate	ᎠᏂᎤᎩᏣᏍᎦ:Hugging
ᏯᏅᎲᎢ	RemotePast	ᎠᏯᏂᎭ:Calling out for him	ᏩᏯᏂᎭ:Distance calling out for him (in the)
ᏯᏅᏗ	Deverbal	ᎠᏯᏂᎭ:Calling out for him	ᏩᏯᏂᎭ:Distance calling out for him (in the)
ᏯᏆᏲᎦ	Immediate	ᎠᏆᏲᎯᎭ:Flipping with finger
ᏯᏈᏴᎥᎠ	Immediate	ᎠᏈᏴᎡᎭ:Paying him
ᏯᏍᏗ	Deverbal	ᎤᏯᎵ:Looking for
ᏯᏎᎧ	Immediate	ᎠᏎᎯᎭ:Pointing at him
ᏯᏎᎮᎢᏌ	Immediate	ᎠᏎᎮᎭ:Showing
ᏯᏓᏪᏙᎦ	Immediate	ᎠᏔᏪᏙᏍᎦ:Kissing
ᏯᏕᎳᏕᎠ	Immediate	ᎠᏖᎳᏕᎭ:Joining
ᏯᏕᏍᏓ	Immediate	ᎠᏖᏍᏗᎭ:Startling him
ᏯᏕᏴᏍᏓ	Immediate	ᎠᏯᏕᏴᏍᏗᎭ:Surrounding it
ᏯᏕᏴᏍᏔᏅᎢ	RemotePast	ᎠᏯᏕᏴᏍᏗᎭ:Surrounding it
ᏯᏕᏴᏍᏗᎭ	PresentContinous	ᎠᏯᏕᏴᏍᏗᎭ:Surrounding it
ᏯᏕᏴᏍᏗᏍᎪᎢ	Habitual	ᎠᏯᏕᏴᏍᏗᎭ:Surrounding it
ᏯᏕᏴᏍᏙᏗ	Deverbal	ᎠᏯᏕᏴᏍᏗᎭ:Surrounding it
ᏯᏗ	Deverbal	ᎠᏯ:Picking up something long
ᏯᏙᏥᏍᏓ	Immediate	ᎠᏙᏥᏗᎭ:Ridiculing
ᏯᏣᏲᎠᎦ	Immediate	ᎦᏣᏲᎯᎭ:Stabbing him
ᏯᏤᏥᏌ	Immediate	ᎠᏤᏤᎭ:Taking revenge on
ᏯᏥᏚᎥᎦ	Immediate	ᎠᏥᏚᎥᏍᎦ:Flirting with
ᏯᏦᏓ	Immediate	ᎠᏦᏖᎭ:Blowing on someone
ᏯᏨᏯ	Immediate	ᎦᏨᏯᏍᎦ:Stinging him
ᏯᏪᎢᏍᏗ	Deverbal	ᎤᏯᏪᎦ:Tired
ᏯᏪᎦ	Immediate	ᎤᏯᏪᎦ:Tired
ᏯᏪᎪᎢ	Habitual	ᎤᏯᏪᎦ:Tired
ᏯᏪᎬᎢ	RemotePast	ᎤᏯᏪᎦ:Tired
ᏯᏪᏐᎵᎭ	PresentContinous	ᎤᏯᏪᏐᎵᎭ:Resting
ᏯᏪᏐᎵᎰᎢ	Habitual	ᎤᏯᏪᏐᎵᎭ:Resting
ᏯᏪᏐᎸᎢ	RemotePast	ᎤᏯᏪᏐᎵᎭ:Resting
ᏯᏪᏐᎸᎦ	Immediate	ᎤᏯᏪᏐᎵᎭ:Resting
ᏯᏪᏐᎸᏍᏗ	Deverbal	ᎤᏯᏪᏐᎵᎭ:Resting
ᏯᏫᏓ	Immediate	ᎦᏯᏫᏗᎭ:Carrying off something long
ᏯᏫᏗᎭ	PresentContinous	ᎦᏯᏫᏗᎭ:Carrying off something long
ᏯᏫᏗᏍᎪᎢ	Habitual	ᎦᏯᏫᏗᎭ:Carrying off something long
ᏯᏫᏘᏗ	Deverbal	ᎦᏯᏫᏗᎭ:Carrying off something long
ᏯᏫᏛᎲᎢ	RemotePast	ᎦᏯᏫᏗᎭ:Carrying off something long
ᏰᎢᏍᏗ	Deverbal	ᎠᏰᎦ:Waking up
ᏰᎦ	Immediate	ᎠᏰᎦ:Waking up
ᏰᎧᎳᎦ	Immediate	ᏓᏰᎧᎳᏍᎦ:Stacking
ᏰᎧᎳᏅᎢ	RemotePast	ᏓᏰᎧᎳᏍᎦ:Stacking
ᏰᎧᎳᏍᎦ	PresentContinous	ᏓᏰᎧᎳᏍᎦ:Stacking
ᏰᎧᎳᏍᎪᎢ	Habitual	ᏓᏰᎧᎳᏍᎦ:Stacking
ᏰᎧᎳᏗ	Deverbal	ᏓᏰᎧᎳᏍᎦ:Stacking
ᏰᎪᎢ	Habitual	ᎠᏰᎦ:Waking up
ᏰᎭ	PresentContinous	ᎦᏰᎭ:Holding something solid
ᏰᎮᏍᏔ	Immediate	ᎦᏰᎭ:Holding something solid
ᏰᎮᏍᏗ	Deverbal	ᎦᏰᎭ:Holding something solid
ᏰᎮᏍᏛᎢ	RemotePast	ᎦᏰᎭ:Holding something solid
ᏰᎰᎢ	Habitual	ᎦᏰᎭ:Holding something solid
ᏰᎳ	Immediate	ᎠᏰᎵᎠ:Mocking him
ᏰᎳᎦ	Immediate	ᎠᏰᎶᎭ:Cutting with a knife
ᏰᎴᏒᎢ	RemotePast	ᎠᏰᎵ:Driving a car
ᏰᎵ	PresentContinous	ᎠᏰᎵ:Driving a car
ᏰᎵᎠ	PresentContinous	ᎠᏰᎵᎠ:Mocking him
ᏰᎵᎢᏍᏗ	Deverbal	ᎠᏰᎵᎠ:Mocking him
ᏰᎵᎦ	Immediate	ᎠᏰᎵ:Driving a car
ᏰᎵᏉ	Other	ᏰᎵᏉ:To be able to
ᏰᎵᏍᎪᎢ	Habitual	ᎠᏰᎵᎠ:Mocking him
ᏰᎵᏐᎢ	Habitual	ᎠᏰᎵ:Driving a car
ᏰᎶᎭ	PresentContinous	ᎠᏰᎶᎭ:Cutting with a knife
ᏰᎶᎰᎢ	Habitual	ᎠᏰᎶᎭ:Cutting with a knife
ᏰᎶᎸᎢ	RemotePast	ᎠᏰᎶᎭ:Cutting with a knife
ᏰᎶᏍᏗ	Deverbal	ᎠᏰᎶᎭ:Cutting with a knife
ᏰᎸᎥᎢ	RemotePast	ᎠᏰᎵᎠ:Mocking him
ᏰᎸᎭ	PresentContinous	ᎤᏰᎸᎭ:Intending
ᏰᎸᎮᏍᏔ	Immediate	ᎤᏰᎸᎭ:Wishing to say
ᏰᎸᎰᎢ	Habitual	ᎤᏰᎸᎭ:Intending
ᏰᎸᎾ	Immediate	ᎤᏰᎸᎭ:Intending
ᏰᎸᏅᎢ	RemotePast	ᎤᏰᎸᎭ:Intending
ᏰᎸᏍᏗ	Deverbal	ᎠᏰᎵ:Driving a car
ᏰᎸᏗ	Deverbal	ᎤᏰᎸᎭ:Wishing to say
ᏰᏒᎢ	RemotePast	ᎠᏱ:Carrying something solid
ᏰᏣ	Immediate	ᎤᏰᏥᎦ:Smiling
ᏰᏥᎦ	PresentContinous	ᎤᏰᏥᎦ:Smiling
ᏰᏥᎪᎢ	Habitual	ᎤᏰᏥᎦ:Smiling
ᏰᏥᏗ	Deverbal	ᎤᏰᏥᎦ:Smiling
ᏰᏨᎢ	RemotePast	ᎤᏰᏥᎦ:Smiling	ᎠᏰᎦ:Waking up
ᏰᏩ	Immediate	ᎦᏰᏫᏍᎦ:Sewing
ᏰᏫᏍᎦ	PresentContinous	ᎦᏰᏫᏍᎦ:Sewing
ᏰᏫᏍᎪᎢ	Habitual	ᎦᏰᏫᏍᎦ:Sewing
ᏰᏫᏍᏗ	Deverbal	ᎦᏰᏫᏍᎦ:Sewing
ᏰᏫᏒᎢ	RemotePast	ᎦᏰᏫᏍᎦ:Sewing
Ᏹ	PresentContinous	ᎠᏱ:Carrying something solid
ᏱᎠ	PresentContinous	ᎠᏱᎠ:Picking up something long from the ground
ᏱᎥᎢ	RemotePast	ᎠᏱᎠ:Picking up something long from the ground
ᏱᏍᎪᎢ	Habitual	ᎠᏯ:Picking up something long	ᎠᏱᎠ:Picking up something long from the ground
ᏱᏐᎢ	Habitual	ᎠᏱ:Carrying something solid
ᏱᏗ	Deverbal	ᎠᏱᎠ:Picking up something long from the ground
ᏲᎢᏯ	PresentContinous	ᎤᏲᎢᏯ:Being bad
ᏲᎢᏲᎢᏍᏗ	Deverbal	ᎤᏲᎢᏯ:Being bad
ᏲᎢᏲᎦ	Immediate	ᎤᏲᎢᏯ:Being bad
ᏲᎢᏲᎪᎢ	Habitual	ᎤᏲᎢᏯ:Being bad
ᏲᎢᏲᏨᎢ	RemotePast	ᎤᏲᎢᏯ:Being bad
ᏲᎣᎭ	Immediate	ᎠᏲᎣᏍᎦ:Lost (die)
ᏲᎣᎯᏍᏗ	Deverbal	ᎠᏲᎣᏍᎦ:Lost (die)
ᏲᎣᏍᎦ	PresentContinous	ᎠᏲᎣᏍᎦ:Lost (die)
ᏲᎣᏍᎪᎢ	Habitual	ᎠᏲᎣᏍᎦ:Lost (die)
ᏲᎣᏒᎢ	RemotePast	ᎠᏲᎣᏍᎦ:Lost (die)
ᏲᎦ	Immediate	ᎠᏲᎯᎭ:Bringing something solid
ᏲᎭ	Immediate	ᎤᏲᏍᎦ:Turning loose
ᏲᎭᎦ	Immediate	ᎠᏲᎯᎭ:Shooting
ᏲᎯᎭ	PresentContinous	ᎠᏲᎯᎭ:Bringing something solid
ᏲᎯᎰᎢ	Habitual	ᎠᏲᎯᎭ:Bringing something solid
ᏲᎯᏍᏓ	Immediate	ᎠᏲᎯᏍᏗᎭ:Quitting
ᏲᎯᏍᏓᏅᎢ	RemotePast	ᎠᏲᎯᏍᏗᎭ:Quitting
ᏲᎯᏍᏗ	Deverbal	ᎤᏲᏍᎦ:Turning loose	ᎠᏲᎯᎭ:Bringing something solid
ᏲᎯᏍᏗᎭ	PresentContinous	ᎠᏲᎯᏍᏗᎭ:Quitting
ᏲᎯᏍᏗᏍᎪᎢ	Habitual	ᎠᏲᎯᏍᏗᎭ:Quitting
ᏲᎯᏍᏙᏗ	Deverbal	ᎠᏲᎯᏍᏗᎭ:Quitting
ᏲᎱᏌ	Immediate	ᎤᏲᎱᏎᎭ:Losing it
ᏲᎱᏎᎭ	PresentContinous	ᎤᏲᎱᏎᎭ:Losing it
ᏲᎱᏎᎰᎢ	Habitual	ᎤᏲᎱᏎᎭ:Losing it
ᏲᎱᏎᎸᎢ	RemotePast	ᎤᏲᎱᏎᎭ:Losing it
ᏲᎱᏎᏗ	Deverbal	ᎤᏲᎱᏎᎭ:Losing it
ᏲᎳᏅᎥᎦ	Immediate	ᎠᏲᎳᏅᎥᏍᎦ:Carving it
ᏲᎳᏅᎥᏍᎦ	PresentContinous	ᎠᏲᎳᏅᎥᏍᎦ:Carving it
ᏲᎳᏅᎥᏍᎪᎢ	Habitual	ᎠᏲᎳᏅᎥᏍᎦ:Carving it
ᏲᎳᏅᏅᎢ	RemotePast	ᎠᏲᎳᏅᎥᏍᎦ:Carving it
ᏲᎳᏅᏗ	Deverbal	ᎠᏲᎳᏅᎥᏍᎦ:Carving it
ᏲᎵᎦ	Immediate	ᎠᏲᎵᎭ:Greeting him
ᏲᎵᎭ	PresentContinous	ᎠᏲᎵᎭ:Greeting him
ᏲᎵᎰᎢ	Habitual	ᎠᏲᎵᎭ:Greeting him
ᏲᎵᎸᎢ	RemotePast	ᎠᏲᎵᎭ:Greeting him
ᏲᎵᏍᏗ	Deverbal	ᎠᏲᎵᎭ:Greeting him
ᏲᎸᎢ	RemotePast	ᎠᏲᎯᎭ:Shooting
ᏲᎾ	Other	ᏲᎾ:Genus: Orsus Americanus
ᏲᏍᎦ	PresentContinous	ᎤᏲᏍᎦ:Turning loose
ᏲᏍᎪᎢ	Habitual	ᎤᏲᏍᎦ:Turning loose
ᏲᏍᏓ	Immediate	ᎠᏲᏍᏗᎭ:Ruining it
ᏲᏍᏔᏅᎢ	RemotePast	ᎠᏲᏍᏗᎭ:Ruining it
ᏲᏍᏗ	Deverbal	ᎠᏲᎯᎭ:Shooting
ᏲᏍᏗᎭ	PresentContinous	ᎠᏲᏍᏗᎭ:Ruining it
ᏲᏍᏗᏍᎪᎢ	Habitual	ᎠᏲᏍᏗᎭ:Ruining it
ᏲᏍᏙᏗ	Deverbal	ᎠᏲᏍᏗᎭ:Ruining it
ᏲᏎᏍᏔ	Immediate	ᎤᏲᏏᎭ:Hungry
ᏲᏎᏍᏛᎢ	RemotePast	ᎤᏲᏏᎭ:Hungry
ᏲᏏᎭ	PresentContinous	ᎤᏲᏏᎭ:Hungry
ᏲᏏᏍᎪᎢ	Habitual	ᎤᏲᏏᎭ:Hungry
ᏲᏏᏍᏗ	Deverbal	ᎤᏲᏏᎭ:Hungry
ᏲᏒᎢ	RemotePast	ᎤᏲᏍᎦ:Turning loose
ᏲᏓᎦ	Immediate	ᎤᏲᏓᎩᎠ:Itching
ᏲᏓᎩᎠ	PresentContinous	ᎤᏲᏓᎩᎠ:Itching
ᏲᏓᎩᏍᎪᎢ	Habitual	ᎤᏲᏓᎩᎠ:Itching
ᏲᏓᎩᏍᏗ	Deverbal	ᎤᏲᏓᎩᎠ:Itching
ᏲᏓᎬᎢ	RemotePast	ᎤᏲᏓᎩᎠ:Itching
ᏳᎦ	Immediate	ᎠᏱ:Carrying something solid
ᏳᎵᏍᏇᏚᎤᏗ	Deverbal	ᏂᎦᎵᏍᏇᏚᎢᎭ:Because of
ᏳᏆᏓ	Immediate	ᎤᏳᏆᏗᎠ:Has a toothache
ᏳᏆᏗᎠ	PresentContinous	ᎤᏳᏆᏗᎠ:Has a toothache
ᏳᏆᏗᏍᎪᎢ	Habitual	ᎤᏳᏆᏗᎠ:Has a toothache
ᏳᏆᏗᏍᏗ	Deverbal	ᎤᏳᏆᏗᎠ:Has a toothache
ᏳᏆᏛᎢ	RemotePast	ᎤᏳᏆᏗᎠ:Has a toothache
ᏳᏩᎾ	PresentContinous	ᎤᏳᏩᎾ:Hairy
ᏳᏩᏁᏍᏔ	Immediate	ᎤᏳᏩᎾ:Hairy
ᏳᏩᏁᏍᏛᎢ	RemotePast	ᎤᏳᏩᎾ:Hairy
ᏳᏩᏃᎢ	Habitual	ᎤᏳᏩᎾ:Hairy
ᏳᏩᏅᏗ	Deverbal	ᎤᏳᏩᎾ:Hairy
ᏳᏪᏍᏗ	Deverbal	ᏂᎦᏪᎠ:Saying again
ᏳᏲᎰᎾᏓ	Immediate	ᏕᎦᏳᏲᎰᎾᏗᎭ:Rolling or skidding logs downhill
ᏳᏲᎰᎾᏔᏅᎢ	RemotePast	ᏕᎦᏳᏲᎰᎾᏗᎭ:Rolling or skidding logs downhill
ᏳᏲᎰᎾᏗᎭ	PresentContinous	ᏕᎦᏳᏲᎰᎾᏗᎭ:Rolling or skidding logs downhill
ᏳᏲᎰᎾᏗᏍᎪᎢ	Habitual	ᏕᎦᏳᏲᎰᎾᏗᎭ:Rolling or skidding logs downhill
ᏳᏲᎰᎾᏙᏗ	Deverbal	ᏕᎦᏳᏲᎰᎾᏗᎭ:Rolling or skidding logs downhill
ᏴᎠ	Immediate	ᎠᏴᎡᎭ:Taking something long from him
ᏴᎡᎭ	PresentContinous	ᎠᏴᎡᎭ:Taking something long or something liquid to him
ᏴᎡᎰᎢ	Habitual	ᎠᏴᎡᎭ:Taking something long or something liquid to him
ᏴᎡᎸᎢ	RemotePast	ᎠᏴᎡᎭ:Taking something long or something liquid to him
ᏴᎡᏗ	Deverbal	ᎠᏴᎡᎭ:Taking something long or something liquid to him
ᏴᎥᎢ	RemotePast	ᎠᏯ:Picking up something long	ᎠᏱᎠ:Fetching something long
ᏴᎥᏌ	Immediate	ᎠᏴᎡᎭ:Taking something long or something liquid to him
ᏴᎦ	Immediate	ᏓᏴᎩᎠ:Tickling him
ᏴᎩ	Other	ᏴᎩ:Spear
ᏴᎩᎠ	PresentContinous	ᏓᏴᎩᎠ:Tickling him
ᏴᎩᏍᎪᎢ	Habitual	ᏓᏴᎩᎠ:Tickling him
ᏴᎩᏍᏗ	Deverbal	ᏓᏴᎩᎠ:Tickling him
ᏴᎩᏒᎢ	RemotePast	ᏓᏴᎩᎠ:Tickling him
ᏴᎭᎦ	Immediate	ᎠᏴᎯᎭ:Entering
ᏴᎯᎭ	PresentContinous	ᎠᏴᎯᎭ:Entering
ᏴᎯᎰᎢ	Habitual	ᎠᏴᎯᎭ:Entering
ᏴᎸᎢ	RemotePast	ᎠᏴᎯᎭ:Entering
ᏴᎾᏌ	Other	ᏴᎾᏌ:Genus: Bison Bison
ᏴᏅᏈᏛᎠᏗ	Deverbal	ᎠᏴᏅᏈᏛᎥᏍᎦ:Hemming
ᏴᏅᏈᏛᎥᎦ	Immediate	ᎠᏴᏅᏈᏛᎥᏍᎦ:Hemming
ᏴᏅᏈᏛᎥᏍᎦ	PresentContinous	ᎠᏴᏅᏈᏛᎥᏍᎦ:Hemming
ᏴᏅᏈᏛᎥᏍᎪᎢ	Habitual	ᎠᏴᏅᏈᏛᎥᏍᎦ:Hemming
ᏴᏅᏈᏛᏅᎢ	RemotePast	ᎠᏴᏅᏈᏛᎥᏍᎦ:Hemming
ᏴᏍᎩᎷᏙᎦ	PresentContinous	ᎤᏴᏍᎩᎷᏙᎦ:Sniffling
ᏴᏍᎩᎷᏙᎪᎢ	Habitual	ᎤᏴᏍᎩᎷᏙᎦ:Sniffling
ᏴᏍᎩᎷᏙᎸᎢ	RemotePast	ᎤᏴᏍᎩᎷᏙᎦ:Sniffling
ᏴᏍᎩᎷᏙᏗ	Deverbal	ᎤᏴᏍᎩᎷᏙᎦ:Sniffling
ᏴᏍᏓ	Immediate	ᎠᏴᏍᏗᎭ:Being carried by something solid
ᏴᏍᏓᎦ	Immediate	ᎤᏴᏍᏓᎩᎠ:Intoxicated
ᏴᏍᏓᎩᎠ	PresentContinous	ᎤᏴᏍᏓᎩᎠ:Intoxicated
ᏴᏍᏓᎩᏍᎪᎢ	Habitual	ᎤᏴᏍᏓᎩᎠ:Intoxicated
ᏴᏍᏓᎩᏍᏗ	Deverbal	ᎤᏴᏍᏓᎩᎠ:Intoxicated
ᏴᏍᏓᎬᎢ	RemotePast	ᎤᏴᏍᏓᎩᎠ:Intoxicated
ᏴᏍᏔᏅᎢ	RemotePast	ᎠᏴᏍᏗᎭ:Being carried by something solid
ᏴᏍᏗ	Deverbal	ᎠᏴᎯᎭ:Entering	ᎠᏱ:Carrying something solid
ᏴᏍᏗᎭ	PresentContinous	ᎠᏴᏍᏗᎭ:Being carried by something solid
ᏴᏍᏗᏍᎪᎢ	Habitual	ᎠᏴᏍᏗᎭ:Being carried by something solid
ᏴᏍᏙᏗ	Deverbal	ᎠᏴᏍᏗᎭ:Being carried by something solid
ᏴᏍᏙᏯᏍᎦ	PresentContinous	ᏚᏴᏍᏙᏯᏍᎦ:Sneezing
ᏴᏍᏙᏯᏍᎪᎢ	Habitual	ᏚᏴᏍᏙᏯᏍᎦ:Sneezing
ᏴᏍᏙᏯᏍᏗ	Deverbal	ᏚᏴᏍᏙᏯᏍᎦ:Sneezing
ᏴᏍᏙᏯᏣ	Immediate	ᏚᏴᏍᏙᏯᏍᎦ:Sneezing
ᏴᏍᏙᏴᎢ	RemotePast	ᏚᏴᏍᏙᏯᏍᎦ:Sneezing
ᏴᏫ	Other	ᏴᏫ:Person
ᏴᏫᏔ	Immediate	ᎠᏴᏫᏘᎭ:Finding something long
ᏴᏫᏘᎭ	PresentContinous	ᎠᏴᏫᏘᎭ:Finding something long
ᏴᏫᏘᏍᎪᎢ	Habitual	ᎠᏴᏫᏘᎭ:Finding something long
ᏴᏫᏛᎲᎢ	RemotePast	ᎠᏴᏫᏘᎭ:Finding something long
ᏴᏫᏛᏗ	Deverbal	ᎠᏴᏫᏘᎭ:Finding something long
